//MAP CONVERTED BY dmm2tgm.py THIS HEADER COMMENT PREVENTS RECONVERSION, DO NOT REMOVE
"bo" = (
/obj/structure/bonfire/prelit,
/turf/open/floor/plating/dirt/jungle/dark/lit,
/area/overmap_encounter/planetoid/jungle/explored)
"bx" = (
/obj/structure/reagent_dispensers/watertank,
/obj/effect/decal/cleanable/dirt,
/obj/effect/decal/cleanable/cobweb/cobweb2,
/turf/open/floor/plasteel/dark,
/area/ruin/powered)
"bE" = (
/obj/structure/table/reinforced,
/obj/machinery/chem_dispenser/drinks/fullupgrade,
/obj/effect/decal/cleanable/dirt,
/turf/open/floor/plasteel/dark,
/area/ruin/powered)
"bO" = (
/obj/structure/closet/crate/secure/weapon,
/obj/effect/decal/cleanable/glass,
/turf/open/floor/plasteel/dark,
/area/ruin/powered)
"bP" = (
/obj/vehicle/ridden/atv{
	dir = 8
	},
/obj/effect/decal/cleanable/dirt,
/turf/open/floor/plating/dirt/jungle/dark/lit,
/area/overmap_encounter/planetoid/jungle/explored)
"bR" = (
/obj/structure/sign/poster/contraband/random,
/turf/closed/wall,
/area/ruin/powered)
"ch" = (
/obj/effect/decal/cleanable/dirt,
/turf/open/floor/plating/dirt/jungle/dark/lit,
/area/overmap_encounter/planetoid/jungle/explored)
"cQ" = (
/obj/structure/table/reinforced,
/obj/item/flashlight/lamp/green,
/turf/open/floor/plasteel/dark,
/area/ruin/powered)
"dV" = (
/obj/effect/decal/cleanable/cobweb/cobweb2,
/obj/effect/decal/cleanable/dirt,
/turf/open/floor/plasteel/dark,
/area/ruin/powered)
"fm" = (
/obj/effect/decal/cleanable/blood/gibs/old,
/turf/open/floor/plasteel/dark,
/area/ruin/powered)
"fL" = (
/obj/effect/decal/cleanable/dirt,
/mob/living/simple_animal/hostile/cult_demon,
/turf/open/floor/plasteel/dark,
/area/ruin/powered)
"fX" = (
/obj/effect/decal/cleanable/chem_pile,
/turf/open/floor/plasteel/dark,
/area/ruin/powered)
"fY" = (
/obj/structure/sign/poster/contraband/random,
/turf/closed/wall/material,
/area/ruin/powered)
"gL" = (
/obj/machinery/door/airlock/grunge,
/turf/open/floor/plasteel/dark,
/area/ruin/powered)
"hc" = (
/obj/machinery/vending/wardrobe/jani_wardrobe,
/obj/effect/decal/cleanable/dirt,
/turf/open/floor/plasteel/dark,
/area/ruin/powered)
"hk" = (
/obj/machinery/light/floor,
/turf/open/floor/plasteel/dark,
/area/ruin/powered)
"hv" = (
/obj/structure/flora/junglebush,
/turf/open/floor/plating/dirt/jungle/lit,
/area/overmap_encounter/planetoid/jungle/explored)
"hX" = (
/obj/effect/decal/remains/xeno,
/turf/open/floor/plating/dirt/jungle/dark/lit,
/area/overmap_encounter/planetoid/jungle/explored)
"it" = (
/obj/structure/flora/tree/jungle/small,
/turf/open/floor/plating/dirt/jungle/lit,
/area/overmap_encounter/planetoid/jungle/explored)
"iw" = (
/obj/structure/table/reinforced,
/obj/item/soap/syndie,
/obj/item/reagent_containers/spray/cleaner,
/obj/item/reagent_containers/spray/cyborg_lube,
/obj/item/reagent_containers/spray/cyborg_drying,
/obj/effect/decal/cleanable/dirt,
/obj/machinery/light/floor,
/turf/open/floor/plasteel/dark,
/area/ruin/powered)
"iC" = (
/obj/structure/chair/office,
/obj/effect/decal/cleanable/dirt,
/obj/effect/decal/cleanable/blood/old,
/obj/effect/decal/remains/human,
/turf/open/floor/plasteel/dark,
/area/ruin/powered)
"jd" = (
/obj/structure/table/reinforced,
/obj/item/reagent_containers/food/drinks/waterbottle/large,
/obj/effect/decal/cleanable/dirt,
/turf/open/floor/plasteel/dark,
/area/ruin/powered)
"jf" = (
/obj/structure/closet/crate/coffin,
/obj/machinery/light/floor,
/turf/open/floor/plasteel/dark,
/area/ruin/powered)
"jB" = (
/obj/effect/decal/cleanable/dirt,
/obj/effect/decal/cleanable/blood/gibs/up,
/turf/open/floor/plasteel/dark,
/area/ruin/powered)
"kb" = (
/turf/closed/wall/material,
/area/ruin/powered)
"kf" = (
/obj/structure/sign/warning/explosives,
/turf/closed/wall,
/area/ruin/powered)
"kM" = (
/obj/structure/closet/crate/trashcart,
/obj/effect/decal/cleanable/dirt,
/obj/effect/spawner/lootdrop/maintenance/eight,
/turf/open/floor/plasteel/dark,
/area/ruin/powered)
"li" = (
/obj/effect/decal/cleanable/blood,
/turf/open/floor/plasteel/dark,
/area/ruin/powered)
"ly" = (
/obj/effect/mob_spawn/human/corpse/assistant,
/turf/open/floor/plating/dirt/jungle/lit,
/area/overmap_encounter/planetoid/jungle/explored)
"mH" = (
/mob/living/simple_animal/hostile/cult_demon{
	health = 120;
	name = "Demonic Foreman";
	resize = 1.25
	},
/turf/open/floor/plating/dirt/jungle/dark/lit,
/area/overmap_encounter/planetoid/jungle/explored)
"mY" = (
/turf/template_noop,
/area/template_noop)
"nd" = (
/obj/structure/flora/rock/jungle,
/turf/open/floor/plating/dirt/jungle/dark/lit,
/area/overmap_encounter/planetoid/jungle/explored)
"nB" = (
/obj/effect/mob_spawn/human/corpse/cargo_tech,
/turf/open/floor/plating/dirt/jungle/lit,
/area/overmap_encounter/planetoid/jungle/explored)
"nJ" = (
/obj/structure/filingcabinet/chestdrawer,
/turf/open/floor/plasteel/dark,
/area/ruin/powered)
"nR" = (
/mob/living/simple_animal/hostile/cult_demon,
/obj/effect/decal/cleanable/dirt,
/turf/open/floor/plasteel/dark,
/area/ruin/powered)
"oR" = (
/obj/structure/flora/junglebush/large,
/turf/open/floor/plating/dirt/jungle/lit,
/area/overmap_encounter/planetoid/jungle/explored)
"pm" = (
/obj/structure/table/reinforced,
/obj/item/upgradescroll,
/turf/open/floor/plasteel/dark,
/area/ruin/powered)
"qu" = (
/obj/structure/ore_box,
/turf/open/floor/plating/dirt/jungle/lit,
/area/overmap_encounter/planetoid/jungle/explored)
"qE" = (
/obj/effect/decal/cleanable/glass,
/turf/open/floor/plasteel/dark,
/area/ruin/powered)
"rx" = (
/obj/effect/decal/cleanable/dirt,
/obj/effect/decal/cleanable/blood/gibs/old,
/turf/open/floor/plasteel/dark,
/area/ruin/powered)
"rA" = (
/obj/structure/chair/office,
/obj/effect/mob_spawn/human/corpse/charredskeleton,
/obj/effect/decal/cleanable/dirt,
/obj/effect/decal/cleanable/blood/old,
/turf/open/floor/plasteel/dark,
/area/ruin/powered)
"rV" = (
/obj/structure/fluff/fokoff_sign,
/turf/open/floor/plating/dirt/jungle/dark/lit,
/area/overmap_encounter/planetoid/jungle/explored)
"se" = (
/obj/structure/janitorialcart,
/obj/effect/decal/cleanable/dirt,
/turf/open/floor/plasteel/dark,
/area/ruin/powered)
"sk" = (
/obj/structure/flora/grass/jungle,
/turf/open/floor/plating/dirt/jungle/lit,
/area/overmap_encounter/planetoid/jungle/explored)
"sK" = (
/obj/structure/chair/office/light{
	dir = 8
	},
/obj/effect/decal/cleanable/blood/old,
/turf/open/floor/plasteel/dark,
/area/ruin/powered)
"sQ" = (
/obj/effect/decal/cleanable/oil/slippery,
/turf/open/floor/plasteel/dark,
/area/ruin/powered)
"sW" = (
/obj/vehicle/ridden/atv{
	dir = 4
	},
/obj/effect/decal/cleanable/dirt,
/turf/open/floor/plating/dirt/jungle/dark/lit,
/area/overmap_encounter/planetoid/jungle/explored)
"tv" = (
/obj/structure/chair/office,
/obj/effect/decal/cleanable/blood/old,
/obj/effect/decal/remains/human,
/turf/open/floor/plasteel/dark,
/area/ruin/powered)
"tR" = (
/obj/structure/closet/gimmick/russian,
/obj/effect/decal/cleanable/dirt,
/obj/effect/decal/cleanable/blood/old,
/turf/open/floor/plasteel/dark,
/area/ruin/powered)
"uj" = (
/obj/structure/closet/crate/silvercrate,
/obj/effect/decal/cleanable/dirt,
/turf/open/floor/plasteel/dark,
/area/ruin/powered)
"uD" = (
/obj/item/kirbyplants/random,
/obj/effect/decal/cleanable/cobweb/cobweb2,
/turf/open/floor/plasteel/dark,
/area/ruin/powered)
"wr" = (
/obj/structure/rack,
/obj/item/spacecash/bundle/c1000,
/obj/effect/decal/cleanable/dirt,
/obj/item/fakeartefact,
/obj/item/spacecash/bundle/c1000,
/turf/open/floor/plasteel/dark,
/area/ruin/powered)
"wG" = (
/obj/structure/rack,
/obj/item/spacecash/bundle/c1000,
/obj/item/fakeartefact,
/obj/item/spacecash/bundle/c1000,
/turf/open/floor/plasteel/dark,
/area/ruin/powered)
"wP" = (
/obj/effect/decal/cleanable/dirt,
/obj/effect/decal/cleanable/blood/old,
/turf/open/floor/plasteel/dark,
/area/ruin/powered)
"wQ" = (
/obj/structure/table/reinforced,
/obj/item/phone,
/turf/open/floor/plasteel/dark,
/area/ruin/powered)
"xe" = (
/mob/living/simple_animal/hostile/cult_demon,
/turf/open/floor/plasteel/dark,
/area/ruin/powered)
"xh" = (
/turf/open/floor/plating/dirt/jungle/lit,
/area/overmap_encounter/planetoid/jungle/explored)
"xJ" = (
/obj/structure/closet/crate/grave/loot,
/turf/open/floor/plating/dirt/jungle/lit,
/area/overmap_encounter/planetoid/jungle/explored)
"xY" = (
/obj/structure/reagent_dispensers/watertank/high,
/turf/open/floor/plasteel/dark,
/area/ruin/powered)
"yA" = (
/obj/machinery/door/airlock/grunge{
	dir = 4
	},
/turf/open/floor/plasteel/dark,
/area/ruin/powered)
"yM" = (
/obj/structure/table/reinforced,
/obj/item/gun/ballistic/shotgun/bulldog/unrestricted,
/turf/open/floor/plasteel/dark,
/area/ruin/powered)
"ze" = (
/obj/structure/fence{
	dir = 4
	},
/turf/open/floor/plating/dirt/jungle/lit,
/area/overmap_encounter/planetoid/jungle/explored)
"AF" = (
/obj/vehicle/ridden/wheelchair,
/turf/open/floor/plasteel/dark,
/area/ruin/powered)
"AU" = (
/obj/structure/table/reinforced,
/obj/item/storage/box/drinkingglasses,
/obj/effect/decal/cleanable/dirt,
/obj/effect/decal/cleanable/dirt,
/turf/open/floor/plasteel/dark,
/area/ruin/powered)
"BS" = (
/obj/structure/flora/junglebush/c,
/turf/open/floor/plating/dirt/jungle/lit,
/area/overmap_encounter/planetoid/jungle/explored)
"Da" = (
/obj/structure/filingcabinet/chestdrawer,
/obj/effect/decal/cleanable/cobweb,
/obj/effect/decal/cleanable/dirt,
/turf/open/floor/plasteel/dark,
/area/ruin/powered)
"DC" = (
/obj/effect/decal/cleanable/dirt,
/obj/effect/decal/cleanable/glass,
/turf/open/floor/plasteel/dark,
/area/ruin/powered)
"Ed" = (
/turf/closed/wall,
/area/ruin/powered)
"EL" = (
/obj/structure/fence,
/turf/open/floor/plating/dirt/jungle/lit,
/area/overmap_encounter/planetoid/jungle/explored)
"EY" = (
/turf/closed/wall/rust,
/area/ruin/powered)
"Fh" = (
/obj/machinery/vending/cola/red,
/obj/effect/decal/cleanable/cobweb/cobweb2,
/turf/open/floor/plasteel/dark,
/area/ruin/powered)
"FA" = (
/obj/structure/rack,
/obj/effect/decal/cleanable/dirt,
/obj/effect/spawner/lootdrop/gloves,
/obj/item/spacecash/bundle/c1000,
/turf/open/floor/plasteel/dark,
/area/ruin/powered)
"FK" = (
/obj/effect/decal/cleanable/blood,
/obj/effect/decal/cleanable/glass,
/turf/open/floor/plasteel/dark,
/area/ruin/powered)
"FR" = (
/obj/structure/sign/warning/fire,
/turf/closed/wall/material,
/area/ruin/powered)
"FY" = (
/obj/structure/sign/warning/biohazard,
/turf/closed/wall/rust,
/area/ruin/powered)
"Gq" = (
/obj/structure/flora/rock/jungle,
/turf/open/floor/plating/dirt/jungle/lit,
/area/overmap_encounter/planetoid/jungle/explored)
"GI" = (
/obj/structure/rack,
/obj/effect/spawner/lootdrop/costume,
/obj/item/spacecash/bundle/c1000,
/turf/open/floor/plasteel/dark,
/area/ruin/powered)
"Hk" = (
/obj/machinery/vending/donksofttoyvendor,
/turf/open/floor/plasteel/dark,
/area/ruin/powered)
"Hv" = (
/obj/structure/table/reinforced,
/obj/machinery/chem_dispenser/drinks/beer/fullupgrade,
/turf/open/floor/plasteel/dark,
/area/ruin/powered)
"Hz" = (
/obj/machinery/door/airlock/grunge,
/obj/effect/decal/cleanable/dirt,
/obj/effect/decal/cleanable/glass,
/turf/open/floor/plasteel/dark,
/area/ruin/powered)
"Ig" = (
/obj/effect/decal/cleanable/dirt,
/obj/vehicle/ridden/wheelchair/motorized,
/turf/open/floor/plasteel/dark,
/area/ruin/powered)
"Iq" = (
/obj/structure/chair/comfy/brown,
/mob/living/simple_animal/hostile/cult_demon/greater{
	health = 250;
	name = "The Boss";
	resize = 1.5
	},
/turf/open/floor/plasteel/dark,
/area/ruin/powered)
"KV" = (
/obj/machinery/light/floor,
/obj/effect/decal/cleanable/dirt,
/turf/open/floor/plasteel/dark,
/area/ruin/powered)
"Lh" = (
/obj/structure/chair/office/light{
	dir = 4
	},
/mob/living/simple_animal/hostile/cult_demon,
/turf/open/floor/plasteel/dark,
/area/ruin/powered)
"Lp" = (
/obj/structure/fence{
	dir = 8
	},
/turf/open/floor/plating/dirt/jungle/lit,
/area/overmap_encounter/planetoid/jungle/explored)
"Lu" = (
/obj/structure/sign/warning,
/turf/closed/wall/rust,
/area/ruin/powered)
"LC" = (
/obj/effect/decal/remains/human,
/turf/open/floor/plating/dirt/jungle/dark/lit,
/area/overmap_encounter/planetoid/jungle/explored)
"LP" = (
/mob/living/simple_animal/hostile/cult_demon,
/obj/effect/decal/cleanable/cobweb,
/turf/open/floor/plasteel/dark,
/area/ruin/powered)
"LW" = (
/turf/open/floor/plasteel/dark,
/area/ruin/powered)
"Mq" = (
/obj/structure/table/reinforced,
/obj/item/pen/survival,
/obj/effect/decal/cleanable/dirt,
/obj/item/key,
/turf/open/floor/plasteel/dark,
/area/ruin/powered)
"Mw" = (
/obj/structure/rack,
/obj/effect/decal/cleanable/dirt,
/obj/effect/spawner/lootdrop/costume,
/turf/open/floor/plasteel/dark,
/area/ruin/powered)
"MM" = (
/obj/structure/chair/plastic{
	dir = 1
	},
/obj/effect/decal/cleanable/ash/large,
/obj/effect/decal/cleanable/blood,
/obj/effect/decal/cleanable/dirt,
/turf/open/floor/plasteel/dark,
/area/ruin/powered)
"MW" = (
/obj/effect/decal/cleanable/dirt,
/turf/closed/wall/material,
/area/ruin/powered)
"Nl" = (
/obj/structure/sign/poster/contraband/random,
/turf/closed/wall/rust,
/area/ruin/powered)
"Nm" = (
/obj/structure/tank_dispenser,
/turf/open/floor/plasteel/dark,
/area/ruin/powered)
"Nt" = (
/obj/structure/tank_dispenser,
/obj/effect/decal/cleanable/cobweb/cobweb2,
/turf/open/floor/plasteel/dark,
/area/ruin/powered)
"Og" = (
/obj/structure/closet/crate/trashcart,
/turf/open/floor/plating/dirt/jungle/dark/lit,
/area/overmap_encounter/planetoid/jungle/explored)
"OB" = (
/turf/open/floor/plating/dirt/jungle/dark/lit,
/area/overmap_encounter/planetoid/jungle/explored)
"Pe" = (
/obj/effect/decal/cleanable/ash,
/obj/effect/decal/cleanable/dirt,
/turf/open/floor/plasteel/dark,
/area/ruin/powered)
"PA" = (
/obj/machinery/suit_storage_unit/syndicate,
/obj/effect/decal/cleanable/dirt,
/turf/open/floor/plasteel/dark,
/area/ruin/powered)
"Qt" = (
/obj/structure/flora/tree/jungle,
/turf/open/floor/plating/dirt/jungle/lit,
/area/overmap_encounter/planetoid/jungle/explored)
"QI" = (
/obj/structure/rack,
/obj/item/spacecash/bundle/c1000,
/obj/effect/spawner/lootdrop/gloves,
/obj/item/spacecash/bundle/c1000,
/turf/open/floor/plasteel/dark,
/area/ruin/powered)
"Re" = (
/obj/structure/table/reinforced,
/obj/item/photo/old,
/obj/item/key,
/turf/open/floor/plasteel/dark,
/area/ruin/powered)
"RX" = (
/obj/structure/table/reinforced,
/obj/item/modular_computer/laptop/preset/civilian,
/turf/open/floor/plasteel/dark,
/area/ruin/powered)
"Sg" = (
/obj/machinery/door/airlock/grunge,
/obj/effect/decal/cleanable/dirt,
/turf/open/floor/plasteel/dark,
/area/ruin/powered)
"Sz" = (
/obj/structure/closet/ammunitionlocker,
/turf/open/floor/plasteel/dark,
/area/ruin/powered)
"SJ" = (
/obj/structure/sign/warning/nosmoking,
/turf/closed/wall,
/area/ruin/powered)
"SU" = (
/obj/structure/table/reinforced,
/obj/item/paper_bin,
/obj/item/spacecash/bundle/c1000,
/turf/open/floor/plasteel/dark,
/area/ruin/powered)
"Ta" = (
/obj/structure/closet/secure_closet/engineering_electrical,
/obj/effect/decal/cleanable/greenglow,
/turf/open/floor/plasteel/dark,
/area/ruin/powered)
"Tp" = (
/obj/structure/rack,
/obj/effect/spawner/lootdrop/gloves,
/obj/item/spacecash/bundle/c1000,
/turf/open/floor/plasteel/dark,
/area/ruin/powered)
"Tr" = (
/obj/effect/decal/cleanable/ash,
/obj/structure/bed/dogbed,
/turf/open/floor/plasteel/dark,
/area/ruin/powered)
"TI" = (
/obj/structure/sign/warning/electricshock,
/turf/closed/wall,
/area/ruin/powered)
"TY" = (
/obj/structure/closet/crate/internals,
/obj/effect/decal/cleanable/dirt,
/turf/open/floor/plasteel/dark,
/area/ruin/powered)
"UH" = (
/obj/structure/filingcabinet,
/obj/effect/decal/cleanable/cobweb/cobweb2,
/turf/open/floor/plasteel/dark,
/area/ruin/powered)
"Vp" = (
/obj/structure/filingcabinet,
/obj/effect/decal/cleanable/cobweb,
/turf/open/floor/plasteel/dark,
/area/ruin/powered)
"VO" = (
/obj/structure/rack,
/obj/machinery/light/floor,
/obj/item/spacecash/bundle/c1000,
/obj/item/fakeartefact,
/obj/item/spacecash/bundle/c1000,
/turf/open/floor/plasteel/dark,
/area/ruin/powered)
"Wa" = (
/obj/structure/ore_box,
/turf/open/floor/plasteel/dark,
/area/ruin/powered)
"Wi" = (
/obj/item/kirbyplants/random,
/turf/open/floor/plasteel/dark,
/area/ruin/powered)
"Ws" = (
/obj/effect/mob_spawn/human/corpse/pirate,
/turf/open/floor/plating/dirt/jungle/dark/lit,
/area/overmap_encounter/planetoid/jungle/explored)
"Xx" = (
/obj/structure/flora/junglebush/b,
/turf/open/floor/plating/dirt/jungle/lit,
/area/overmap_encounter/planetoid/jungle/explored)
"XS" = (
/obj/effect/decal/cleanable/dirt,
/turf/open/floor/plasteel/dark,
/area/ruin/powered)
"Yp" = (
/obj/structure/reagent_dispensers/fueltank,
/obj/effect/decal/cleanable/dirt,
/turf/open/floor/plasteel/dark,
/area/ruin/powered)
"YX" = (
/obj/effect/decal/cleanable/cobweb,
/obj/effect/decal/cleanable/dirt,
/turf/open/floor/plasteel/dark,
/area/ruin/powered)

(1,1,1) = {"
mY
mY
mY
mY
qu
sk
xh
xh
OB
OB
ch
Gq
xh
mY
mY
mY
mY
mY
mY
mY
"}
(2,1,1) = {"
mY
Ed
Ed
bR
Ed
Ed
xh
OB
rV
LC
ch
xh
Ed
Ed
Ed
Nl
EY
EY
Ed
mY
"}
(3,1,1) = {"
mY
Ed
Da
XS
Lh
EY
BS
ch
sW
OB
OB
xh
Ed
YX
sQ
LW
XS
LW
Ed
mY
"}
(4,1,1) = {"
mY
Ed
nJ
XS
SU
EY
it
OB
ch
OB
OB
Xx
bR
LW
wG
FA
Mw
qE
bR
xh
"}
(5,1,1) = {"
mY
Ed
nJ
LW
sK
EY
xh
OB
ch
ch
OB
OB
Ed
LW
XS
Ig
xe
LW
Ed
xh
"}
(6,1,1) = {"
xh
Ed
PA
KV
Wi
Lu
OB
OB
OB
ch
ch
OB
Ed
LW
Tp
VO
GI
XS
Ed
xh
"}
(7,1,1) = {"
xh
bR
rx
LW
LW
Hz
OB
OB
OB
OB
ch
OB
gL
LW
LW
AF
sQ
XS
Ed
ly
"}
(8,1,1) = {"
xh
EY
Fh
Mq
Hk
Ed
ch
ch
OB
OB
OB
OB
SJ
LW
wr
GI
QI
XS
Ed
xh
"}
(9,1,1) = {"
xh
EY
EY
bR
Ed
Ed
xh
OB
mH
OB
OB
hv
EY
LW
DC
LW
fL
XS
Nl
xh
"}
(10,1,1) = {"
xh
sk
xh
ze
xJ
xh
oR
hX
bo
OB
OB
xh
Nl
XS
sQ
fm
LW
LW
Ed
xh
"}
(11,1,1) = {"
xh
nB
xh
ze
qu
sk
xh
OB
ch
ch
OB
sk
EY
Nt
xY
Yp
xY
Nm
Ed
xh
"}
(12,1,1) = {"
xh
xh
xh
ze
Qt
xh
xh
xh
OB
ch
OB
OB
EY
Ed
Ed
bR
Ed
Ed
Ed
xh
"}
(13,1,1) = {"
xh
xh
sk
Lp
xh
xh
Gq
xh
OB
OB
OB
LC
OB
xh
xh
xh
ze
sk
xJ
xh
"}
(14,1,1) = {"
xh
xh
Xx
ze
xh
xh
xh
xh
xh
OB
OB
OB
ch
OB
xh
oR
ze
xh
Xx
xh
"}
(15,1,1) = {"
xh
Ed
Ed
Ed
Ed
EY
EY
EY
yA
kb
Ed
Ed
ch
ch
OB
Ed
Ed
Ed
EY
xh
"}
(16,1,1) = {"
xh
Ed
Vp
FK
XS
Tr
EY
Wi
LW
XS
Re
Ed
OB
ch
OB
TI
LP
uj
Nl
xh
"}
(17,1,1) = {"
xh
Ed
Hv
XS
cQ
LW
kb
DC
LW
iC
RX
Ed
Og
OB
OB
Sg
wP
bO
EY
xh
"}
(18,1,1) = {"
xh
Ed
bE
Iq
pm
MM
kb
LW
hk
fY
kb
Ed
OB
OB
OB
gL
LW
TY
EY
xh
"}
(19,1,1) = {"
xh
Ed
AU
li
yM
XS
FR
XS
LW
fX
wQ
Ed
bP
OB
xh
kf
LW
jf
Ed
xh
"}
(20,1,1) = {"
xh
Ed
UH
LW
Pe
LW
gL
LW
LW
rA
RX
Ed
ch
OB
xh
Ed
XS
Sz
Ed
xh
"}
(21,1,1) = {"
mY
Ed
MW
kb
fY
kb
kb
Wi
hk
Nl
EY
EY
nd
oR
xh
Ed
XS
tR
Ed
xh
"}
(22,1,1) = {"
mY
EY
hc
jB
DC
XS
Sg
XS
qE
XS
jd
EY
OB
xh
sk
bR
nR
Ta
Ed
mY
"}
(23,1,1) = {"
mY
EY
bx
kM
se
iw
FY
uD
XS
tv
RX
Ed
EL
EL
EL
Ed
dV
Wa
Ed
mY
"}
(24,1,1) = {"
mY
EY
EY
EY
Ed
Ed
EY
Ed
Ed
Ed
Ed
Ed
sk
it
xJ
Ed
Ed
bR
Ed
mY
"}
(25,1,1) = {"
mY
mY
mY
mY
xh
xh
xh
xh
xh
xh
xh
xh
OB
OB
Ws
xh
xh
mY
mY
mY
"}
