//MAP CONVERTED BY dmm2tgm.py THIS HEADER COMMENT PREVENTS RECONVERSION, DO NOT REMOVE
"bi" = (
/obj/item/slimepotion/lovepotion{
	pixel_x = -5;
	pixel_y = 4
	},
/obj/item/slimepotion/slime/sentience{
	pixel_x = 4;
	pixel_y = 1
	},
/obj/effect/decal/cleanable/dirt/dust,
/obj/item/gun/magic/wand/nothing,
/obj/structure/table/wood/fancy,
/turf/open/floor/wood,
/area/ruin/powered)
"cl" = (
/obj/structure/table/wood,
/obj/item/toy/cards/deck/tarot,
/turf/open/floor/wood,
/area/ruin/powered)
"cp" = (
/obj/effect/decal/cleanable/blood/gibs,
/obj/item/toy/plush/among{
	desc = "He seems to practice the ManSus..."
	},
/turf/open/floor/wood,
/area/ruin/powered)
"ev" = (
/obj/structure/table/wood/fancy/cyan,
/obj/machinery/microwave{
	desc = "It's a fucking microwave. How is this even powered?";
	name = "Wizardly Cooking Apparatus"
	},
/turf/open/floor/wood,
/area/ruin/powered)
"fe" = (
/obj/item/restraints/legcuffs/beartrap/energy,
/obj/machinery/door/airlock/wood,
/turf/open/floor/wood,
/area/ruin/powered)
"fu" = (
/obj/structure/flora/ausbushes/ppflowers,
/turf/open/floor/plating/dirt/jungle/dark/lit,
/area/overmap_encounter/planetoid/jungle/explored)
"gf" = (
/obj/structure/table/wood/fancy/cyan,
/obj/item/reagent_containers/food/drinks/soda_cans/thirteenloko,
/obj/item/reagent_containers/food/snacks/chococoin{
	pixel_x = 6;
	pixel_y = 5
	},
/turf/open/floor/wood,
/area/ruin/powered)
"hD" = (
/obj/structure/flora/rock/jungle,
/turf/open/floor/plating/dirt/jungle/dark/lit,
/area/overmap_encounter/planetoid/jungle/explored)
"jh" = (
/obj/item/toy/crayon/white,
/obj/effect/decal/cleanable/blood/gibs/limb,
/turf/open/floor/wood,
/area/ruin/powered)
"lG" = (
/obj/item/storage/book/bible,
/obj/structure/closet/crate/bin,
/obj/item/soulstone/anybody/purified,
/turf/open/floor/wood,
/area/ruin/powered)
"lR" = (
/obj/structure/closet/secure_closet/freezer/meat,
/obj/item/reagent_containers/food/snacks/meat/slab/meatwheat,
/obj/item/reagent_containers/food/snacks/meat/slab/meatwheat,
/obj/item/reagent_containers/food/snacks/meat/slab/meatwheat,
/turf/open/floor/wood,
/area/ruin/powered)
"mP" = (
/obj/machinery/door/airlock/wood{
	dir = 4
	},
/turf/open/floor/wood,
/area/ruin/powered)
"nt" = (
/obj/structure/trap/chill,
/turf/open/water/jungle/lit,
/area/overmap_encounter/planetoid/jungle/explored)
"nV" = (
/obj/item/bedsheet/black,
/obj/structure/bed,
/mob/living/simple_animal/hostile/dark_wizard,
/obj/effect/decal/cleanable/cobweb/cobweb2,
/obj/item/clothing/gloves/combat/wizard,
/turf/open/floor/wood,
/area/ruin/powered)
"oz" = (
/obj/effect/decal/cleanable/dirt/dust,
/obj/machinery/light/small/directional/east,
/turf/open/floor/wood,
/area/ruin/powered)
"oL" = (
/obj/item/flashlight/lamp/bananalamp,
/turf/open/floor/wood,
/area/ruin/powered)
"pL" = (
/obj/structure/trap/fire,
/turf/open/water/jungle/lit,
/area/overmap_encounter/planetoid/jungle/explored)
"qh" = (
/obj/structure/table/wood,
/obj/item/clothing/head/collectable/wizard,
/turf/open/floor/wood,
/area/ruin/powered)
"qD" = (
/obj/effect/decal/cleanable/dirt/dust,
/obj/machinery/light/dim/directional/west,
/turf/open/floor/wood,
/area/ruin/powered)
"rI" = (
/obj/structure/flora/rock,
/turf/open/water/jungle/lit,
/area/overmap_encounter/planetoid/jungle/explored)
"rM" = (
/obj/structure/table/wood,
/obj/item/fakeartefact,
/turf/open/floor/wood,
/area/ruin/powered)
"rS" = (
/obj/structure/table/wood,
/obj/item/toy/cards/deck/kotahi,
/obj/item/coin/gold{
	pixel_x = 9;
	pixel_y = 8
	},
/obj/item/coin/gold{
	pixel_x = -8;
	pixel_y = 7
	},
/obj/item/coin/gold,
/turf/open/floor/wood,
/area/ruin/powered)
"sT" = (
/obj/effect/decal/cleanable/crayon,
/obj/item/shard{
	pixel_x = -5;
	pixel_y = 5
	},
/obj/item/kitchen/knife,
/obj/item/shard{
	pixel_x = 6;
	pixel_y = -8
	},
/turf/open/floor/wood,
/area/ruin/powered)
"tn" = (
/obj/structure/table/wood,
/obj/item/storage/crayons,
/turf/open/floor/wood,
/area/ruin/powered)
"tw" = (
/obj/structure/flora/junglebush,
/turf/open/floor/plating/dirt/jungle/dark/lit,
/area/overmap_encounter/planetoid/jungle/explored)
"tT" = (
/obj/item/toy/plush/narplush,
/turf/open/floor/wood,
/area/ruin/powered)
"vf" = (
/obj/structure/table/wood/fancy/cyan,
/obj/item/reagent_containers/food/snacks/burger/spell,
/obj/item/reagent_containers/food/snacks/dankpocket{
	pixel_x = 8;
	pixel_y = 10
	},
/turf/open/floor/wood,
/area/ruin/powered)
"vk" = (
/obj/item/clothing/suit/armor/riot/chaplain/witchhunter,
/obj/item/clothing/head/helmet/chaplain/witchunter_hat,
/obj/item/claymore/weak,
/obj/item/bodypart/head,
/obj/effect/decal/cleanable/blood/gibs/bubblegum,
/turf/open/water/jungle/lit,
/area/overmap_encounter/planetoid/jungle/explored)
"vB" = (
/obj/effect/decal/cleanable/generic,
/obj/machinery/light/dim/directional/south,
/turf/open/floor/wood,
/area/ruin/powered)
"wL" = (
/obj/item/chair/wood,
/turf/open/floor/wood,
/area/ruin/powered)
"ym" = (
/obj/effect/decal/cleanable/dirt/dust,
/turf/open/floor/wood,
/area/ruin/powered)
"zt" = (
/obj/effect/decal/cleanable/food/pie_smudge,
/turf/open/floor/wood,
/area/ruin/powered)
"Bh" = (
/obj/machinery/door/airlock/wood,
/turf/open/floor/wood,
/area/ruin/powered)
"Bj" = (
/obj/effect/decal/cleanable/food/tomato_smudge,
/turf/open/floor/wood,
/area/ruin/powered)
"Bk" = (
/obj/structure/trap/stun,
/turf/open/floor/wood,
/area/overmap_encounter/planetoid/jungle/explored)
"DP" = (
/obj/item/chair/wood{
	dir = 8
	},
/obj/effect/decal/cleanable/blood/gibs/core,
/turf/open/floor/wood,
/area/ruin/powered)
"Eq" = (
/turf/closed/wall/mineral/wood,
/area/ruin/powered)
"EV" = (
/obj/structure/barricade/wooden,
/obj/structure/curtain/cloth/fancy,
/turf/open/floor/wood,
/area/ruin/powered)
"Go" = (
/mob/living/simple_animal/hostile/dark_wizard,
/turf/open/floor/wood,
/area/ruin/powered)
"Gx" = (
/mob/living/simple_animal/pet/cat/Runtime{
	name = "Witches Familiar"
	},
/turf/open/floor/wood,
/area/ruin/powered)
"GR" = (
/obj/effect/decal/cleanable/dirt/dust,
/turf/open/floor/wood,
/area/overmap_encounter/planetoid/jungle/explored)
"GZ" = (
/obj/structure/trap/damage,
/turf/open/water/jungle/lit,
/area/overmap_encounter/planetoid/jungle/explored)
"HY" = (
/obj/structure/flora/tree/jungle/small,
/turf/open/water/jungle/lit,
/area/overmap_encounter/planetoid/jungle/explored)
"IW" = (
/obj/structure/flora/ausbushes/brflowers,
/turf/open/floor/plating/dirt/jungle/dark/lit,
/area/overmap_encounter/planetoid/jungle/explored)
"JG" = (
/obj/effect/decal/cleanable/blood/gibs/up,
/obj/item/clothing/head/helmet/chaplain,
/turf/open/water/jungle/lit,
/area/overmap_encounter/planetoid/jungle/explored)
"JQ" = (
/obj/structure/flora/tree/jungle,
/turf/open/floor/plating/dirt/jungle/dark/lit,
/area/overmap_encounter/planetoid/jungle/explored)
"Kc" = (
/turf/open/floor/wood,
/area/ruin/powered)
"LK" = (
/obj/structure/barricade/wooden/crude,
/obj/structure/curtain/cloth/fancy,
/turf/open/floor/wood,
/area/ruin/powered)
"Ps" = (
/obj/item/chair/wood{
	dir = 1
	},
/turf/open/floor/wood,
/area/ruin/powered)
"Qm" = (
/turf/open/floor/wood,
/area/overmap_encounter/planetoid/jungle/explored)
"RY" = (
/obj/effect/decal/cleanable/blood/gibs/torso,
/turf/open/water/jungle/lit,
/area/overmap_encounter/planetoid/jungle/explored)
"SI" = (
/obj/structure/trap/damage,
/turf/open/floor/wood,
/area/overmap_encounter/planetoid/jungle/explored)
"UK" = (
/obj/structure/flora/ausbushes/ywflowers,
/turf/open/floor/plating/dirt/jungle/dark/lit,
/area/overmap_encounter/planetoid/jungle/explored)
"Vd" = (
/obj/effect/decal/cleanable/blood/gibs/down,
/obj/item/clothing/suit/armor/riot/chaplain,
/obj/item/claymore/weak,
/turf/open/floor/plating/dirt/jungle/dark/lit,
/area/overmap_encounter/planetoid/jungle/explored)
"We" = (
/turf/open/water/jungle/lit,
/area/overmap_encounter/planetoid/jungle/explored)
"WI" = (
/obj/structure/mineral_door/wood,
/turf/open/floor/wood,
/area/ruin/powered)
"YG" = (
/obj/item/clothing/suit/wizrobe/marisa,
/obj/item/clothing/head/wizard/marisa,
/obj/item/clothing/shoes/sandal/marisa,
/obj/structure/closet/cabinet,
/obj/item/clothing/suit/space/hardsuit/wizard,
/obj/item/staff/broom,
/turf/open/floor/wood,
/area/ruin/powered)
"Zi" = (
/obj/structure/table/wood,
/obj/item/fakeartefact,
/obj/item/scanner_wand{
	pixel_x = -16
	},
/turf/open/floor/wood,
/area/ruin/powered)
"ZG" = (
/turf/open/floor/plating/dirt/jungle/dark/lit,
/area/overmap_encounter/planetoid/jungle/explored)
"ZW" = (
/obj/effect/mob_spawn/human/corpse,
/turf/open/floor/wood,
/area/ruin/powered)

(1,1,1) = {"
fu
tw
IW
We
We
GR
SI
We
We
HY
We
JG
Vd
hD
IW
"}
(2,1,1) = {"
hD
ZG
We
rI
We
Qm
Qm
We
We
We
We
We
We
tw
fu
"}
(3,1,1) = {"
ZG
fu
We
Eq
Eq
mP
mP
Eq
Eq
Eq
Eq
Eq
We
We
JQ
"}
(4,1,1) = {"
tw
nt
We
Eq
lR
ym
Kc
Kc
qD
Go
Kc
Eq
We
We
hD
"}
(5,1,1) = {"
We
We
We
EV
vf
Kc
Ps
tn
rM
cl
wL
Eq
rI
We
ZG
"}
(6,1,1) = {"
HY
We
We
EV
gf
Gx
Kc
rS
Zi
qh
ym
Eq
We
We
We
"}
(7,1,1) = {"
We
We
We
Eq
ev
Kc
oz
Kc
Kc
Kc
Kc
Bh
Qm
Bk
Qm
"}
(8,1,1) = {"
We
We
We
Eq
Eq
Eq
Eq
Bj
DP
jh
Kc
fe
GR
Qm
UK
"}
(9,1,1) = {"
GZ
We
rI
Eq
bi
YG
Eq
Kc
ZW
sT
Kc
Eq
We
We
tw
"}
(10,1,1) = {"
hD
We
We
Eq
tT
ym
WI
Kc
zt
cp
vB
Eq
We
ZG
ZG
"}
(11,1,1) = {"
ZG
IW
We
Eq
nV
oL
Eq
lG
Kc
Kc
ym
Eq
rI
hD
IW
"}
(12,1,1) = {"
fu
ZG
We
Eq
Eq
Eq
Eq
Eq
LK
LK
Eq
Eq
UK
ZG
UK
"}
(13,1,1) = {"
ZG
fu
We
We
We
We
We
We
vk
RY
We
ZG
ZG
fu
ZG
"}
(14,1,1) = {"
JQ
ZG
ZG
We
HY
We
We
pL
We
We
ZG
hD
ZG
ZG
JQ
"}
(15,1,1) = {"
UK
ZG
IW
ZG
We
We
We
hD
ZG
UK
fu
IW
fu
ZG
IW
"}
