//MAP CONVERTED BY dmm2tgm.py THIS HEADER COMMENT PREVENTS RECONVERSION, DO NOT REMOVE
"bi" = (
/obj/item/slimepotion/lovepotion{
	pixel_x = -5;
	pixel_y = 4
	},
/obj/item/slimepotion/slime/sentience{
	pixel_x = 4;
	pixel_y = 1
	},
/obj/effect/decal/cleanable/dirt/dust,
/obj/item/gun/magic/wand/nothing,
/obj/structure/table/wood/fancy,
/turf/open/floor/wood,
/area/ruin/powered)
"bI" = (
/obj/structure/flora/rock,
/turf/open/water/jungle/lit,
/area/overmap_encounter/planetoid/jungle/explored)
"bL" = (
/obj/item/clothing/suit/armor/riot/chaplain/witchhunter,
/obj/item/clothing/head/helmet/chaplain/witchunter_hat,
/obj/item/claymore/weak,
/obj/item/bodypart/head,
/obj/effect/decal/cleanable/blood/gibs/bubblegum,
/turf/open/water/jungle/lit,
/area/overmap_encounter/planetoid/jungle/explored)
"cl" = (
/obj/structure/table/wood,
/obj/item/toy/cards/deck/tarot,
/turf/open/floor/wood,
/area/ruin/powered)
"cp" = (
/obj/effect/decal/cleanable/blood/gibs,
/obj/item/toy/plush/among{
	desc = "He seems to practice the ManSus..."
	},
/turf/open/floor/wood,
/area/ruin/powered)
"ev" = (
/obj/structure/table/wood/fancy/cyan,
/obj/machinery/microwave{
	desc = "It's a fucking microwave. How is this even powered?";
	name = "Wizardly Cooking Apparatus"
	},
/turf/open/floor/wood,
/area/ruin/powered)
"gf" = (
/obj/structure/table/wood/fancy/cyan,
/obj/item/reagent_containers/food/drinks/soda_cans/thirteenloko,
/obj/item/reagent_containers/food/snacks/chococoin{
	pixel_x = 6;
	pixel_y = 5
	},
/turf/open/floor/wood,
/area/ruin/powered)
"jh" = (
/obj/item/toy/crayon/white,
/obj/effect/decal/cleanable/blood/gibs/limb,
/turf/open/floor/wood,
/area/ruin/powered)
"kH" = (
/obj/structure/trap/fire,
/turf/open/water/jungle/lit,
/area/overmap_encounter/planetoid/jungle/explored)
"lg" = (
/obj/effect/decal/cleanable/dirt/dust,
/turf/open/floor/wood,
/area/overmap_encounter/planetoid/jungle/explored)
"lG" = (
/obj/item/storage/book/bible,
/obj/structure/closet/crate/bin,
/obj/item/soulstone/anybody/purified,
/turf/open/floor/wood,
/area/ruin/powered)
"lR" = (
/obj/structure/closet/secure_closet/freezer/meat,
/obj/item/reagent_containers/food/snacks/meat/slab/meatwheat,
/obj/item/reagent_containers/food/snacks/meat/slab/meatwheat,
/obj/item/reagent_containers/food/snacks/meat/slab/meatwheat,
/turf/open/floor/wood,
/area/ruin/powered)
"nV" = (
/obj/item/bedsheet/black,
/obj/structure/bed,
/mob/living/simple_animal/hostile/dark_wizard,
/obj/effect/decal/cleanable/cobweb/cobweb2,
/obj/item/clothing/gloves/combat/wizard,
/turf/open/floor/wood,
/area/ruin/powered)
"oL" = (
/obj/item/flashlight/lamp/bananalamp,
/turf/open/floor/wood,
/area/ruin/powered)
"oO" = (
/obj/structure/flora/ausbushes/ywflowers,
/turf/open/floor/plating/dirt/jungle/dark/lit,
/area/overmap_encounter/planetoid/jungle/explored)
"qh" = (
/obj/structure/table/wood,
/obj/item/clothing/head/collectable/wizard,
/turf/open/floor/wood,
/area/ruin/powered)
"qN" = (
/turf/open/floor/plating/dirt/jungle/dark/lit,
/area/overmap_encounter/planetoid/jungle/explored)
"rM" = (
/obj/structure/table/wood,
/obj/item/fakeartefact,
/turf/open/floor/wood,
/area/ruin/powered)
"rS" = (
/obj/structure/table/wood,
/obj/item/toy/cards/deck/kotahi,
/obj/item/coin/gold{
	pixel_x = 9;
	pixel_y = 8
	},
/obj/item/coin/gold{
	pixel_x = -8;
	pixel_y = 7
	},
/obj/item/coin/gold,
/turf/open/floor/wood,
/area/ruin/powered)
"se" = (
/obj/effect/decal/cleanable/dirt/dust,
/obj/machinery/light/small/directional/east,
/turf/open/floor/wood,
/area/ruin/powered)
"sT" = (
/obj/effect/decal/cleanable/crayon,
/obj/item/shard{
	pixel_x = -5;
	pixel_y = 5
	},
/obj/item/kitchen/knife,
/obj/item/shard{
	pixel_x = 6;
	pixel_y = -8
	},
/turf/open/floor/wood,
/area/ruin/powered)
"sV" = (
/obj/structure/trap/stun,
/turf/open/floor/wood,
/area/overmap_encounter/planetoid/jungle/explored)
"tn" = (
/obj/structure/table/wood,
/obj/item/storage/crayons,
/turf/open/floor/wood,
/area/ruin/powered)
"tT" = (
/obj/item/toy/plush/narplush,
/turf/open/floor/wood,
/area/ruin/powered)
"vf" = (
/obj/structure/table/wood/fancy/cyan,
/obj/item/reagent_containers/food/snacks/burger/spell,
/obj/item/reagent_containers/food/snacks/dankpocket{
	pixel_x = 8;
	pixel_y = 10
	},
/turf/open/floor/wood,
/area/ruin/powered)
"vi" = (
/obj/structure/trap/damage,
/turf/open/water/jungle/lit,
/area/overmap_encounter/planetoid/jungle/explored)
"wL" = (
/obj/item/chair/wood,
/turf/open/floor/wood,
/area/ruin/powered)
"ym" = (
/obj/effect/decal/cleanable/dirt/dust,
/turf/open/floor/wood,
/area/ruin/powered)
"zd" = (
/obj/structure/flora/ausbushes/brflowers,
/turf/open/floor/plating/dirt/jungle/dark/lit,
/area/overmap_encounter/planetoid/jungle/explored)
"zt" = (
/obj/effect/decal/cleanable/food/pie_smudge,
/turf/open/floor/wood,
/area/ruin/powered)
"Bh" = (
/obj/structure/flora/ausbushes/ppflowers,
/turf/open/floor/plating/dirt/jungle/dark/lit,
/area/overmap_encounter/planetoid/jungle/explored)
"Bj" = (
/obj/effect/decal/cleanable/food/tomato_smudge,
/turf/open/floor/wood,
/area/ruin/powered)
"Dr" = (
/obj/effect/decal/cleanable/generic,
/obj/machinery/light/dim/directional/south,
/turf/open/floor/wood,
/area/ruin/powered)
"DP" = (
/obj/item/chair/wood{
	dir = 8
	},
/obj/effect/decal/cleanable/blood/gibs/core,
/turf/open/floor/wood,
/area/ruin/powered)
"Eq" = (
/turf/closed/wall/mineral/wood,
/area/ruin/powered)
"EV" = (
/obj/structure/barricade/wooden,
/obj/structure/curtain/cloth/fancy,
/turf/open/floor/wood,
/area/ruin/powered)
"FA" = (
/obj/structure/flora/rock/jungle,
/turf/open/floor/plating/dirt/jungle/dark/lit,
/area/overmap_encounter/planetoid/jungle/explored)
"FW" = (
/obj/structure/trap/chill,
/turf/open/water/jungle/lit,
/area/overmap_encounter/planetoid/jungle/explored)
"Go" = (
/mob/living/simple_animal/hostile/dark_wizard,
/turf/open/floor/wood,
/area/ruin/powered)
"Gx" = (
/mob/living/simple_animal/pet/cat/Runtime{
	name = "Witches Familiar"
	},
/turf/open/floor/wood,
/area/ruin/powered)
"Is" = (
/obj/item/restraints/legcuffs/beartrap/energy,
/obj/machinery/door/airlock/wood,
/turf/open/floor/wood,
/area/ruin/powered)
"Kc" = (
/turf/open/floor/wood,
/area/ruin/powered)
"Kd" = (
/turf/open/floor/wood,
/area/overmap_encounter/planetoid/jungle/explored)
"Kr" = (
/obj/machinery/door/airlock/wood{
	dir = 4
	},
/turf/open/floor/wood,
/area/ruin/powered)
"KQ" = (
/obj/structure/flora/tree/jungle/small,
/turf/open/water/jungle/lit,
/area/overmap_encounter/planetoid/jungle/explored)
"LK" = (
/obj/structure/barricade/wooden/crude,
/obj/structure/curtain/cloth/fancy,
/turf/open/floor/wood,
/area/ruin/powered)
"LU" = (
/obj/machinery/door/airlock/wood,
/turf/open/floor/wood,
/area/ruin/powered)
"Nd" = (
/turf/open/water/jungle/lit,
/area/overmap_encounter/planetoid/jungle/explored)
"Ps" = (
/obj/item/chair/wood{
	dir = 1
	},
/turf/open/floor/wood,
/area/ruin/powered)
"Qm" = (
/obj/effect/decal/cleanable/blood/gibs/up,
/obj/item/clothing/head/helmet/chaplain,
/turf/open/water/jungle/lit,
/area/overmap_encounter/planetoid/jungle/explored)
"RG" = (
/obj/effect/decal/cleanable/blood/gibs/down,
/obj/item/clothing/suit/armor/riot/chaplain,
/obj/item/claymore/weak,
/turf/open/floor/plating/dirt/jungle/dark/lit,
/area/overmap_encounter/planetoid/jungle/explored)
"Sh" = (
/obj/structure/flora/tree/jungle,
/turf/open/floor/plating/dirt/jungle/dark/lit,
/area/overmap_encounter/planetoid/jungle/explored)
"TF" = (
/obj/structure/trap/damage,
/turf/open/floor/wood,
/area/overmap_encounter/planetoid/jungle/explored)
"Uy" = (
/obj/effect/decal/cleanable/dirt/dust,
/obj/machinery/light/dim/directional/west,
/turf/open/floor/wood,
/area/ruin/powered)
"WI" = (
/obj/structure/mineral_door/wood,
/turf/open/floor/wood,
/area/ruin/powered)
"Yw" = (
/obj/effect/decal/cleanable/blood/gibs/torso,
/turf/open/water/jungle/lit,
/area/overmap_encounter/planetoid/jungle/explored)
"YG" = (
/obj/item/clothing/suit/wizrobe/marisa,
/obj/item/clothing/head/wizard/marisa,
/obj/item/clothing/shoes/sandal/marisa,
/obj/structure/closet/cabinet,
/obj/item/clothing/suit/space/hardsuit/wizard,
/obj/item/staff/broom,
/turf/open/floor/wood,
/area/ruin/powered)
"Zi" = (
/obj/structure/table/wood,
/obj/item/fakeartefact,
/obj/item/scanner_wand{
	pixel_x = -16
	},
/turf/open/floor/wood,
/area/ruin/powered)
"ZP" = (
/obj/structure/flora/junglebush,
/turf/open/floor/plating/dirt/jungle/dark/lit,
/area/overmap_encounter/planetoid/jungle/explored)
"ZW" = (
/obj/effect/mob_spawn/human/corpse,
/turf/open/floor/wood,
/area/ruin/powered)

(1,1,1) = {"
Bh
ZP
zd
Nd
Nd
lg
TF
Nd
Nd
KQ
Nd
Qm
RG
FA
zd
"}
(2,1,1) = {"
FA
qN
Nd
bI
Nd
Kd
Kd
Nd
Nd
Nd
Nd
Nd
Nd
ZP
Bh
"}
(3,1,1) = {"
qN
Bh
Nd
Eq
Eq
Kr
Kr
Eq
Eq
Eq
Eq
Eq
Nd
Nd
Sh
"}
(4,1,1) = {"
ZP
FW
Nd
Eq
lR
ym
Kc
Kc
Uy
Go
Kc
Eq
Nd
Nd
FA
"}
(5,1,1) = {"
Nd
Nd
Nd
EV
vf
Kc
Ps
tn
rM
cl
wL
Eq
bI
Nd
qN
"}
(6,1,1) = {"
KQ
Nd
Nd
EV
gf
Gx
Kc
rS
Zi
qh
ym
Eq
Nd
Nd
Nd
"}
(7,1,1) = {"
Nd
Nd
Nd
Eq
ev
Kc
se
Kc
Kc
Kc
Kc
LU
Kd
sV
Kd
"}
(8,1,1) = {"
Nd
Nd
Nd
Eq
Eq
Eq
Eq
Bj
DP
jh
Kc
Is
lg
Kd
oO
"}
(9,1,1) = {"
vi
Nd
bI
Eq
bi
YG
Eq
Kc
ZW
sT
Kc
Eq
Nd
Nd
ZP
"}
(10,1,1) = {"
FA
Nd
Nd
Eq
tT
ym
WI
Kc
zt
cp
Dr
Eq
Nd
qN
qN
"}
(11,1,1) = {"
qN
zd
Nd
Eq
nV
oL
Eq
lG
Kc
Kc
ym
Eq
bI
FA
zd
"}
(12,1,1) = {"
Bh
qN
Nd
Eq
Eq
Eq
Eq
Eq
LK
LK
Eq
Eq
oO
qN
oO
"}
(13,1,1) = {"
qN
Bh
Nd
Nd
Nd
Nd
Nd
Nd
bL
Yw
Nd
qN
qN
Bh
qN
"}
(14,1,1) = {"
Sh
qN
qN
Nd
KQ
Nd
Nd
kH
Nd
Nd
qN
FA
qN
qN
Sh
"}
(15,1,1) = {"
oO
qN
zd
qN
Nd
Nd
Nd
FA
qN
oO
Bh
zd
Bh
qN
zd
"}
