//MAP CONVERTED BY dmm2tgm.py THIS HEADER COMMENT PREVENTS RECONVERSION, DO NOT REMOVE
"aB" = (
/turf/open/floor/plating/grass/jungle/lit,
/area/overmap_encounter/planetoid/jungle/explored)
"bh" = (
/obj/structure/fence/cut/large{
	dir = 4
	},
/turf/open/floor/plating/grass/jungle/lit,
/area/overmap_encounter/planetoid/jungle/explored)
"bF" = (
/obj/structure/closet/crate/bin,
/obj/item/trash/popcorn,
/obj/item/trash/candy,
/obj/item/grenade/frag{
	name = "garbage"
	},
/turf/open/floor/wood,
/area/ruin/powered)
"bM" = (
/turf/open/floor/carpet/red,
/area/ruin/powered)
"dN" = (
/obj/machinery/hydroponics/soil,
/turf/open/floor/plating/grass/jungle/lit,
/area/overmap_encounter/planetoid/jungle/explored)
"dW" = (
/obj/structure/barricade/wooden/crude,
/obj/machinery/door/airlock/wood{
	dir = 8
	},
/turf/open/floor/wood,
/area/ruin/powered)
"eE" = (
/turf/open/floor/wood{
	icon_state = "wood-broken7"
	},
/area/ruin/powered)
"eT" = (
/obj/structure/flora/junglebush,
/turf/open/floor/plating/grass/jungle/lit,
/area/overmap_encounter/planetoid/jungle/explored)
"eX" = (
/mob/living/simple_animal/hostile/rat{
	dir = 4
	},
/turf/open/floor/carpet/red,
/area/ruin/powered)
"eZ" = (
/turf/open/floor/wood{
	icon_state = "wood-broken5"
	},
/area/ruin/powered)
"fu" = (
/obj/structure/table/wood,
/obj/item/multitool{
	pixel_x = -5;
	pixel_y = 6
	},
/obj/item/wirecutters/old{
	pixel_y = -1
	},
/obj/item/stack/cable_coil/random/five{
	pixel_x = 9;
	pixel_y = 6
	},
/turf/open/floor/wood,
/area/ruin/powered)
"gg" = (
/mob/living/simple_animal/hostile/rat{
	dir = 1
	},
/obj/machinery/light/small/directional/south,
/turf/open/floor/wood,
/area/ruin/powered)
"gp" = (
/obj/structure/barricade/wooden,
/obj/machinery/door/airlock/wood{
	dir = 8
	},
/turf/open/floor/wood,
/area/ruin/powered)
"gr" = (
/obj/machinery/light/broken/directional/west,
/turf/open/floor/wood,
/area/ruin/powered)
"gz" = (
/obj/structure/fence/cut/medium,
/turf/open/floor/plating/grass/jungle/lit,
/area/overmap_encounter/planetoid/jungle/explored)
"gI" = (
/obj/structure/table/wood/reinforced,
/obj/item/ammo_casing/shotgun/improvised{
	pixel_x = 6;
	pixel_y = -5
	},
/obj/item/ammo_casing/shotgun/improvised{
	pixel_x = -6;
	pixel_y = 6
	},
/obj/item/ammo_casing/shotgun/improvised{
	pixel_x = 6;
	pixel_y = 8
	},
/turf/open/floor/wood{
	icon_state = "wood-broken7"
	},
/area/ruin/powered)
"he" = (
/obj/structure/flora/tree/jungle/small,
/turf/open/floor/plating/grass/jungle/lit,
/area/overmap_encounter/planetoid/jungle/explored)
"iH" = (
/turf/open/floor/wood{
	icon_state = "wood-broken2"
	},
/area/ruin/powered)
"iK" = (
/obj/item/seeds/corn/snapcorn,
/turf/open/floor/plating/grass/jungle/lit,
/area/overmap_encounter/planetoid/jungle/explored)
"iS" = (
/obj/structure/chair/plastic{
	dir = 8
	},
/turf/open/floor/wood,
/area/ruin/powered)
"lN" = (
/obj/structure/table/wood,
/obj/item/grenade/chem_grenade/ez_clean{
	pixel_x = -4;
	pixel_y = 3
	},
/obj/item/grenade/chem_grenade/cleaner{
	pixel_x = 6;
	pixel_y = 7
	},
/obj/item/research_notes/loot/small{
	origin_type = "explosives";
	pixel_y = 4;
	value = 1200
	},
/turf/open/floor/wood,
/area/ruin/powered)
"lR" = (
/obj/structure/floodlight_frame,
/turf/open/floor/plating/grass/jungle/lit,
/area/overmap_encounter/planetoid/jungle/explored)
"mK" = (
/obj/machinery/hydroponics/soil,
/obj/item/reagent_containers/food/snacks/grown/corn,
/turf/open/floor/plating/grass/jungle/lit,
/area/overmap_encounter/planetoid/jungle/explored)
"od" = (
/obj/structure/barricade/wooden,
/turf/open/floor/plating/grass/jungle/lit,
/area/overmap_encounter/planetoid/jungle/explored)
"oz" = (
/obj/structure/flora/tree/jungle,
/turf/open/floor/plating/grass/jungle/lit,
/area/overmap_encounter/planetoid/jungle/explored)
"oD" = (
/turf/open/floor/wood{
	icon_state = "wood-broken"
	},
/area/ruin/powered)
"pV" = (
/mob/living/simple_animal/hostile/rat,
/obj/machinery/light/small/broken/directional/north,
/turf/open/floor/wood,
/area/ruin/powered)
"qj" = (
/obj/machinery/hydroponics/soil,
/obj/item/grown/corncob,
/turf/open/floor/plating/grass/jungle/lit,
/area/overmap_encounter/planetoid/jungle/explored)
"qp" = (
/obj/structure/noticeboard{
	desc = "A board with many old marks and paper scraps on it.";
	dir = 4;
	name = "Teacher's Board"
	},
/turf/closed/wall/mineral/wood,
/area/ruin/powered)
"qF" = (
/obj/machinery/light/small/directional/north,
/turf/open/floor/wood,
/area/ruin/powered)
"re" = (
/obj/structure/flora/junglebush/b,
/turf/open/floor/plating/grass/jungle/lit,
/area/overmap_encounter/planetoid/jungle/explored)
"rf" = (
/obj/structure/fence{
	dir = 4
	},
/turf/open/floor/plating/grass/jungle/lit,
/area/overmap_encounter/planetoid/jungle/explored)
"ri" = (
/obj/structure/chair/plastic{
	dir = 8
	},
/turf/open/floor/wood{
	icon_state = "wood-broken"
	},
/area/ruin/powered)
"rF" = (
/mob/living/simple_animal/hostile/asteroid/hivelord/legion/dwarf{
	desc = "You can still see what was once a rather small human under the shifting mass of corruption. Its trying to keep you away from the main office for some reason.";
	name = "Student"
	},
/turf/open/floor/wood,
/area/ruin/powered)
"rN" = (
/obj/structure/dresser,
/obj/item/research_notes/loot/medium{
	origin_type = "explosives";
	pixel_y = 6
	},
/turf/open/floor/wood{
	icon_state = "wood-broken5"
	},
/area/ruin/powered)
"sV" = (
/obj/structure/chair/comfy/black,
/turf/open/floor/carpet/red,
/area/ruin/powered)
"sX" = (
/obj/structure/bed,
/obj/item/bedsheet/rd,
/turf/open/floor/wood,
/area/ruin/powered)
"vj" = (
/obj/machinery/door/airlock/wood,
/turf/open/floor/wood,
/area/ruin/powered)
"wj" = (
/obj/item/grown/corncob,
/turf/open/floor/plating/grass/jungle/lit,
/area/overmap_encounter/planetoid/jungle/explored)
"wq" = (
/obj/structure/table/wood,
/obj/item/grenade/firecracker{
	pixel_x = -8;
	pixel_y = -5
	},
/obj/item/grenade/firecracker{
	pixel_x = -8;
	pixel_y = 8
	},
/obj/item/grenade/firecracker{
	pixel_x = 4
	},
/turf/open/floor/wood,
/area/ruin/powered)
"wK" = (
/obj/structure/table/wood,
/obj/item/book/manual/wiki/grenades{
	desc = "Some kind of manual about making hellish grenades and explosives. Completely unreadable, but you feel as though you've gained a level in explosives.";
	name = "Pete's Lesson";
	pixel_y = 3
	},
/turf/open/floor/wood{
	icon_state = "wood-broken5"
	},
/area/ruin/powered)
"xs" = (
/obj/structure/table/wood/reinforced,
/obj/item/storage/belt/utility/chief/full,
/turf/open/floor/wood{
	icon_state = "wood-broken2"
	},
/area/ruin/powered)
"xt" = (
/obj/machinery/light/small/directional/south,
/turf/open/floor/wood{
	icon_state = "wood-broken2"
	},
/area/ruin/powered)
"yu" = (
/turf/closed/wall/mineral/wood,
/area/ruin/powered)
"yJ" = (
/obj/structure/table/wood/reinforced,
/obj/item/grenade/clusterbuster/soap{
	name = "Reality Devastator"
	},
/turf/open/floor/wood,
/area/ruin/powered)
"zg" = (
/obj/item/transfer_valve{
	pixel_x = 7;
	pixel_y = 2
	},
/obj/item/transfer_valve{
	pixel_x = -8;
	pixel_y = 2
	},
/obj/structure/table/wood/fancy/orange,
/turf/open/floor/wood,
/area/ruin/powered)
"zK" = (
/obj/machinery/hydroponics/soil,
/obj/item/seeds/corn,
/turf/open/floor/plating/grass/jungle/lit,
/area/overmap_encounter/planetoid/jungle/explored)
"AO" = (
/obj/structure/fence/corner{
	dir = 5
	},
/turf/open/floor/plating/grass/jungle/lit,
/area/overmap_encounter/planetoid/jungle/explored)
"Bz" = (
/obj/structure/closet/toolcloset,
/turf/open/floor/wood,
/area/ruin/powered)
"Cr" = (
/obj/structure/table/wood,
/obj/item/grenade/chem_grenade/large{
	pixel_x = -7;
	pixel_y = -1
	},
/obj/item/grenade/chem_grenade/large{
	pixel_x = 4;
	pixel_y = 9
	},
/obj/item/screwdriver/old{
	pixel_y = 10
	},
/turf/open/floor/wood,
/area/ruin/powered)
"DU" = (
/mob/living/simple_animal/hostile/asteroid/hivelord/legion{
	name = "Student"
	},
/turf/open/floor/wood{
	icon_state = "wood-broken7"
	},
/area/ruin/powered)
"FM" = (
/obj/structure/fence,
/turf/open/floor/plating/grass/jungle/lit,
/area/overmap_encounter/planetoid/jungle/explored)
"GE" = (
/obj/structure/chair/stool/bar{
	dir = 4;
	name = "teacher's stool"
	},
/turf/open/floor/wood,
/area/ruin/powered)
"Ho" = (
/obj/structure/table/wood/reinforced,
/obj/item/flashlight/lamp/green,
/turf/open/floor/wood,
/area/ruin/powered)
"Jd" = (
/obj/effect/mob_spawn/human/corpse/charredskeleton{
	desc = "Many die in the pursuit of science. Even more die making homebrew explosives in a random shack on some frontier planet.";
	name = "charred remains of the Teacher"
	},
/turf/open/floor/carpet/red,
/area/ruin/powered)
"JD" = (
/obj/item/reagent_containers/food/snacks/grown/corn,
/turf/open/floor/plating/grass/jungle/lit,
/area/overmap_encounter/planetoid/jungle/explored)
"Kq" = (
/obj/structure/flora/rock,
/turf/open/floor/plating/grass/jungle/lit,
/area/overmap_encounter/planetoid/jungle/explored)
"NP" = (
/obj/structure/flora/junglebush/large,
/turf/open/floor/plating/grass/jungle/lit,
/area/overmap_encounter/planetoid/jungle/explored)
"Rc" = (
/obj/structure/chair/plastic{
	dir = 8
	},
/turf/open/floor/wood{
	icon_state = "wood-broken7"
	},
/area/ruin/powered)
"SI" = (
/obj/structure/table/wood,
/obj/item/grenade/stingbang{
	pixel_x = -5;
	pixel_y = 9
	},
/obj/item/lighter/greyscale{
	pixel_x = 6
	},
/turf/open/floor/wood{
	icon_state = "wood-broken2"
	},
/area/ruin/powered)
"TB" = (
/turf/open/floor/wood,
/area/ruin/powered)
"TQ" = (
/obj/structure/bookcase/random,
/turf/open/floor/wood{
	icon_state = "wood-broken2"
	},
/area/ruin/powered)
"Vq" = (
/obj/structure/table/wood/reinforced,
/obj/item/grenade/chem_grenade/adv_release{
	pixel_x = 6;
	pixel_y = 5
	},
/obj/item/grenade/chem_grenade/adv_release{
	pixel_x = -5;
	pixel_y = 5
	},
/obj/item/grenade/chem_grenade/adv_release{
	pixel_y = 5
	},
/turf/open/floor/wood{
	icon_state = "wood-broken"
	},
/area/ruin/powered)
"VH" = (
/obj/structure/flora/junglebush/c,
/turf/open/floor/plating/grass/jungle/lit,
/area/overmap_encounter/planetoid/jungle/explored)
"VL" = (
/obj/structure/barricade/wooden/crude,
/obj/machinery/door/airlock/wood,
/turf/open/floor/wood,
/area/ruin/powered)
"WW" = (
/obj/structure/table/wood,
/obj/item/clothing/mask/gas/welding,
/obj/item/research_notes/loot/small{
	origin_type = "explosives";
	pixel_y = 3;
	value = 1200
	},
/turf/open/floor/wood{
	icon_state = "wood-broken4"
	},
/area/ruin/powered)
"XK" = (
/obj/machinery/light/broken/directional/south,
/turf/open/floor/wood,
/area/ruin/powered)
"Ya" = (
/obj/machinery/light/small/directional/south,
/turf/open/floor/wood,
/area/ruin/powered)
"Ym" = (
/obj/item/tank/internals/plasma/full{
	pixel_x = -8;
	pixel_y = -1
	},
/obj/item/tank/internals/plasma/full{
	pixel_x = 5
	},
/obj/item/tank/internals/oxygen{
	pixel_x = -7;
	pixel_y = 8
	},
/obj/item/tank/internals/oxygen{
	pixel_x = 4;
	pixel_y = -6
	},
/obj/structure/table/wood/fancy/orange,
/turf/open/floor/wood{
	icon_state = "wood-broken5"
	},
/area/ruin/powered)
"YS" = (
/mob/living/simple_animal/hostile/cockroach/glockroach,
/turf/open/floor/plating/grass/jungle/lit,
/area/overmap_encounter/planetoid/jungle/explored)
"Zo" = (
/turf/open/floor/wood{
	icon_state = "wood-broken4"
	},
/area/ruin/powered)

(1,1,1) = {"
aB
eT
aB
aB
aB
eT
NP
aB
aB
re
aB
aB
aB
aB
eT
"}
(2,1,1) = {"
aB
yu
yu
yu
yu
yu
yu
yu
yu
Kq
aB
aB
he
re
aB
"}
(3,1,1) = {"
oz
yu
sX
oD
bF
yu
zg
Ym
yu
yu
Kq
aB
aB
eT
NP
"}
(4,1,1) = {"
aB
yu
rN
eX
bM
vj
eE
TB
Bz
yu
qp
qp
yu
yu
aB
"}
(5,1,1) = {"
aB
yu
pV
Jd
gg
yu
oD
iH
Zo
gr
oD
GE
TQ
yu
aB
"}
(6,1,1) = {"
aB
yu
xs
sV
gI
yu
qF
Zo
rF
TB
TB
eE
TB
VL
re
"}
(7,1,1) = {"
aB
yu
Ho
Vq
yJ
yu
TB
TB
Zo
TB
eZ
Zo
oD
yu
aB
"}
(8,1,1) = {"
oz
yu
yu
yu
yu
yu
gp
dW
yu
lN
fu
wK
Ya
yu
eT
"}
(9,1,1) = {"
aB
rf
VH
aB
wj
aB
aB
od
yu
yu
Rc
TB
oD
yu
aB
"}
(10,1,1) = {"
NP
rf
aB
zK
aB
qj
re
zK
aB
yu
wq
SI
XK
yu
aB
"}
(11,1,1) = {"
aB
bh
aB
dN
iK
dN
lR
mK
aB
yu
iS
TB
DU
yu
re
"}
(12,1,1) = {"
aB
rf
aB
mK
JD
dN
aB
qj
VH
yu
WW
Cr
xt
yu
aB
"}
(13,1,1) = {"
aB
rf
wj
dN
YS
zK
wj
mK
aB
yu
TB
ri
TB
yu
aB
"}
(14,1,1) = {"
aB
AO
FM
FM
FM
FM
gz
FM
FM
yu
yu
yu
yu
yu
aB
"}
(15,1,1) = {"
aB
aB
aB
oz
re
aB
aB
eT
NP
aB
aB
aB
aB
aB
eT
"}
