//MAP CONVERTED BY dmm2tgm.py THIS HEADER COMMENT PREVENTS RECONVERSION, DO NOT REMOVE
"cO" = (
/obj/machinery/door/airlock/survival_pod,
/turf/open/floor/plasteel/tech/grid,
/area/ruin/powered)
"eI" = (
/turf/open/water/jungle,
/area/overmap_encounter/planetoid/jungle/explored)
"gW" = (
/obj/structure/fence/corner{
	dir = 8
	},
/turf/open/floor/plating/grass/jungle/lit,
/area/overmap_encounter/planetoid/jungle/explored)
"hh" = (
/obj/structure/closet/crate/freezer,
/obj/item/organ/cyberimp/arm/surgery,
/obj/item/organ/eyes/night_vision/mushroom,
/obj/item/organ/heart/cybernetic/tier3,
/obj/item/organ/liver/plasmaman,
/obj/item/organ/tongue/robot,
/obj/item/organ/moth_wings,
/obj/item/organ/stomach/cybernetic/tier2,
/turf/open/floor/plasteel/freezer,
/area/ruin/powered)
"ih" = (
/obj/item/stack/rods,
/turf/open/floor/plating/grass/jungle/lit,
/area/overmap_encounter/planetoid/jungle/explored)
"iv" = (
/obj/structure/fence/corner{
	dir = 1
	},
/turf/open/floor/plating/grass/jungle/lit,
/area/overmap_encounter/planetoid/jungle/explored)
"iA" = (
/turf/open/floor/plating/grass/jungle/lit,
/area/overmap_encounter/planetoid/jungle/explored)
"jE" = (
/obj/structure/fence{
	dir = 4
	},
/turf/open/floor/plating/grass/jungle/lit,
/area/overmap_encounter/planetoid/jungle/explored)
"kn" = (
/turf/closed/mineral,
/area/overmap_encounter/planetoid/jungle/explored)
"kp" = (
/obj/structure/flora/rock,
/turf/open/floor/plating/dirt/jungle/wasteland/lit,
/area/overmap_encounter/planetoid/jungle/explored)
"kz" = (
/obj/structure/flora/stump,
/turf/open/floor/plating/dirt/jungle/dark/lit,
/area/overmap_encounter/planetoid/jungle/explored)
"nT" = (
/turf/open/floor/plating/dirt/jungle/wasteland/lit,
/area/overmap_encounter/planetoid/jungle/explored)
"nW" = (
/obj/machinery/power/shuttle/engine/electric{
	dir = 8
	},
/turf/open/floor/plasteel/tech/grid,
/area/ruin/powered)
"pN" = (
/obj/item/clothing/mask/breath/medical,
/turf/open/floor/plasteel/freezer,
/area/ruin/powered)
"rk" = (
/obj/machinery/hydroponics/soil,
/obj/item/reagent_containers/food/snacks/salad/jungle,
/turf/open/floor/plating/grass/jungle/lit,
/area/overmap_encounter/planetoid/jungle/explored)
"sc" = (
/obj/machinery/hydroponics/soil,
/turf/open/floor/plating/grass/jungle/lit,
/area/overmap_encounter/planetoid/jungle/explored)
"to" = (
/obj/effect/decal/cleanable/food/tomato_smudge,
/turf/open/floor/plating/grass/jungle/lit,
/area/overmap_encounter/planetoid/jungle/explored)
"uY" = (
/turf/closed/wall/mineral/titanium/survival/pod,
/area/ruin/powered)
"wk" = (
/obj/item/cultivator/rake,
/mob/living/simple_animal/hostile/venus_human_trap,
/turf/open/floor/plating/grass/jungle/lit,
/area/overmap_encounter/planetoid/jungle/explored)
"yj" = (
/obj/structure/fence/end{
	dir = 8
	},
/turf/open/floor/plating/grass/jungle/lit,
/area/overmap_encounter/planetoid/jungle/explored)
"zv" = (
/mob/living/simple_animal/hostile/venus_human_trap,
/turf/open/water/jungle,
/area/overmap_encounter/planetoid/jungle/explored)
"AF" = (
/obj/structure/flora/rock/jungle,
/turf/open/floor/plating/grass/jungle/lit,
/area/overmap_encounter/planetoid/jungle/explored)
"CD" = (
/obj/structure/flora/junglebush/b,
/turf/open/floor/plating/grass/jungle/lit,
/area/overmap_encounter/planetoid/jungle/explored)
"FE" = (
/obj/item/scythe,
/turf/open/floor/plating/grass/jungle/lit,
/area/overmap_encounter/planetoid/jungle/explored)
"FL" = (
/obj/structure/flora/rock/jungle,
/turf/open/floor/plating/dirt/jungle/dark/lit,
/area/overmap_encounter/planetoid/jungle/explored)
"IH" = (
/obj/structure/flora/junglebush/large,
/turf/open/floor/plating/grass/jungle/lit,
/area/overmap_encounter/planetoid/jungle/explored)
"IX" = (
/turf/open/floor/plating/dirt/jungle,
/area/overmap_encounter/planetoid/jungle/explored)
"Jv" = (
/obj/structure/flora/rock/pile,
/turf/open/floor/plating/dirt/jungle/dark/lit,
/area/overmap_encounter/planetoid/jungle/explored)
"Ka" = (
/obj/structure/flora/rock/pile,
/turf/open/floor/plating/dirt/jungle/wasteland/lit,
/area/overmap_encounter/planetoid/jungle/explored)
"Ld" = (
/obj/item/clothing/suit/hooded/wintercoat/medical,
/turf/open/floor/plasteel/freezer,
/area/ruin/powered)
"LO" = (
/turf/open/floor/plating/dirt/jungle/dark/lit,
/area/overmap_encounter/planetoid/jungle/explored)
"Mf" = (
/obj/item/storage/bag/medical,
/obj/machinery/light/small/directional/south,
/turf/open/floor/plasteel/tech/grid,
/area/ruin/powered)
"Nj" = (
/mob/living/simple_animal/bot/medbot/rockplanet,
/obj/item/circuitboard/machine/techfab/department/medical,
/turf/open/floor/plasteel/freezer,
/area/ruin/powered)
"OP" = (
/obj/structure/fence/cut/large{
	dir = 8
	},
/turf/open/floor/plating/grass/jungle/lit,
/area/overmap_encounter/planetoid/jungle/explored)
"Pe" = (
/obj/structure/closet/crate/freezer/blood,
/turf/open/floor/plasteel/tech/grid,
/area/ruin/powered)
"PC" = (
/obj/item/stack/rods,
/turf/open/floor/plating/dirt/jungle/dark/lit,
/area/overmap_encounter/planetoid/jungle/explored)
"RQ" = (
/obj/machinery/hydroponics/soil,
/obj/effect/decal/cleanable/food/tomato_smudge,
/turf/open/floor/plating/grass/jungle/lit,
/area/overmap_encounter/planetoid/jungle/explored)
"SI" = (
/obj/effect/turf_decal/dept/medical,
/turf/closed/wall/mineral/titanium/survival/pod,
/area/ruin/powered)
"Tt" = (
/obj/structure/flora/junglebush,
/turf/open/floor/plating/grass/jungle/lit,
/area/overmap_encounter/planetoid/jungle/explored)
"TT" = (
/obj/structure/flora/junglebush/c,
/turf/open/floor/plating/grass/jungle/lit,
/area/overmap_encounter/planetoid/jungle/explored)
"UL" = (
/obj/structure/flora/tree/jungle/small,
/turf/open/floor/plating/grass/jungle/lit,
/area/overmap_encounter/planetoid/jungle/explored)
"Vu" = (
/obj/structure/frame/machine,
/turf/open/floor/plasteel/tech/grid,
/area/ruin/unpowered)
"VP" = (
/obj/effect/decal/cleanable/blood/splatter,
/turf/open/floor/plating/dirt/jungle/dark/lit,
/area/overmap_encounter/planetoid/jungle/explored)
"WA" = (
/obj/effect/spawner/structure/window/survival_pod,
/turf/open/floor/plasteel,
/area/ruin/powered)
"XP" = (
/obj/structure/fence,
/turf/open/floor/plating/grass/jungle/lit,
/area/overmap_encounter/planetoid/jungle/explored)
"Ys" = (
/obj/structure/flora/rock,
/turf/open/floor/plating/grass/jungle/lit,
/area/overmap_encounter/planetoid/jungle/explored)
"Yv" = (
/obj/structure/fence/door,
/turf/open/floor/plating/grass/jungle/lit,
/area/overmap_encounter/planetoid/jungle/explored)

(1,1,1) = {"
Tt
nT
iA
kn
nT
kn
nT
Ka
iA
TT
iA
iA
iA
CD
iA
"}
(2,1,1) = {"
kp
Ka
kn
kn
kn
kn
kn
iA
UL
iA
iA
Tt
iA
iA
iA
"}
(3,1,1) = {"
nT
kn
kn
WA
WA
kn
kp
Tt
TT
iA
CD
iA
iA
TT
iA
"}
(4,1,1) = {"
nT
nT
uY
Nj
hh
uY
nT
gW
XP
XP
XP
XP
iv
iA
IH
"}
(5,1,1) = {"
iA
nT
SI
Pe
Mf
SI
iA
jE
CD
FE
TT
iA
jE
AF
iA
"}
(6,1,1) = {"
UL
AF
uY
Ld
pN
uY
ih
jE
Tt
rk
sc
CD
jE
iA
iA
"}
(7,1,1) = {"
Tt
iA
nW
cO
cO
Vu
CD
iA
eI
eI
zv
iA
jE
iA
iA
"}
(8,1,1) = {"
AF
iA
LO
FL
VP
Jv
iA
ih
RQ
eI
eI
eI
OP
iA
iA
"}
(9,1,1) = {"
IH
iA
Jv
LO
PC
LO
jE
iA
wk
sc
eI
eI
jE
Tt
iA
"}
(10,1,1) = {"
iA
LO
LO
LO
LO
ih
CD
to
sc
eI
eI
eI
jE
iA
IH
"}
(11,1,1) = {"
iA
FL
LO
LO
FL
OP
iA
eI
eI
eI
eI
iA
jE
iA
iA
"}
(12,1,1) = {"
iA
LO
kz
LO
iA
iA
iA
eI
eI
eI
eI
TT
jE
iA
iA
"}
(13,1,1) = {"
Tt
LO
LO
LO
TT
iA
ih
iA
eI
eI
Ys
iA
Yv
iA
iA
"}
(14,1,1) = {"
iA
LO
LO
iA
iA
IH
iA
CD
iA
TT
iA
iA
yj
iA
iA
"}
(15,1,1) = {"
iA
IX
UL
TT
iA
CD
iA
iA
Tt
iA
iA
AF
iA
UL
iA
"}
