//MAP CONVERTED BY dmm2tgm.py THIS HEADER COMMENT PREVENTS RECONVERSION, DO NOT REMOVE
"aE" = (
/obj/machinery/light/broken/directional/west,
/turf/open/floor/wood,
/area/ruin/powered)
"bF" = (
/obj/structure/closet/crate/bin,
/obj/item/trash/popcorn,
/obj/item/trash/candy,
/obj/item/grenade/frag{
	name = "garbage"
	},
/turf/open/floor/wood,
/area/ruin/powered)
"bM" = (
/turf/open/floor/carpet/red,
/area/ruin/powered)
"cc" = (
/obj/structure/fence/cut/medium,
/turf/open/floor/plating/grass/jungle/lit,
/area/overmap_encounter/planetoid/jungle/explored)
"do" = (
/obj/structure/floodlight_frame,
/turf/open/floor/plating/grass/jungle/lit,
/area/overmap_encounter/planetoid/jungle/explored)
"dK" = (
/obj/machinery/hydroponics/soil,
/turf/open/floor/plating/grass/jungle/lit,
/area/overmap_encounter/planetoid/jungle/explored)
"dQ" = (
/mob/living/simple_animal/hostile/rat,
/obj/machinery/light/small/broken/directional/north,
/turf/open/floor/wood,
/area/ruin/powered)
"eE" = (
/turf/open/floor/wood{
	icon_state = "wood-broken7"
	},
/area/ruin/powered)
"eS" = (
/obj/structure/flora/junglebush/b,
/turf/open/floor/plating/grass/jungle/lit,
/area/overmap_encounter/planetoid/jungle/explored)
"eX" = (
/mob/living/simple_animal/hostile/rat{
	dir = 4
	},
/turf/open/floor/carpet/red,
/area/ruin/powered)
"eZ" = (
/turf/open/floor/wood{
	icon_state = "wood-broken5"
	},
/area/ruin/powered)
"fu" = (
/obj/structure/table/wood,
/obj/item/multitool{
	pixel_x = -5;
	pixel_y = 6
	},
/obj/item/wirecutters/old{
	pixel_y = -1
	},
/obj/item/stack/cable_coil/random/five{
	pixel_x = 9;
	pixel_y = 6
	},
/turf/open/floor/wood,
/area/ruin/powered)
"fx" = (
/obj/machinery/hydroponics/soil,
/obj/item/seeds/corn,
/turf/open/floor/plating/grass/jungle/lit,
/area/overmap_encounter/planetoid/jungle/explored)
"gd" = (
/obj/structure/fence,
/turf/open/floor/plating/grass/jungle/lit,
/area/overmap_encounter/planetoid/jungle/explored)
"gI" = (
/obj/structure/table/wood/reinforced,
/obj/item/ammo_casing/shotgun/improvised{
	pixel_x = 6;
	pixel_y = -5
	},
/obj/item/ammo_casing/shotgun/improvised{
	pixel_x = -6;
	pixel_y = 6
	},
/obj/item/ammo_casing/shotgun/improvised{
	pixel_x = 6;
	pixel_y = 8
	},
/turf/open/floor/wood{
	icon_state = "wood-broken7"
	},
/area/ruin/powered)
"hD" = (
/obj/machinery/light/small/directional/south,
/turf/open/floor/wood,
/area/ruin/powered)
"ic" = (
/obj/structure/flora/junglebush/c,
/turf/open/floor/plating/grass/jungle/lit,
/area/overmap_encounter/planetoid/jungle/explored)
"iH" = (
/turf/open/floor/wood{
	icon_state = "wood-broken2"
	},
/area/ruin/powered)
"iS" = (
/obj/structure/chair/plastic{
	dir = 8
	},
/turf/open/floor/wood,
/area/ruin/powered)
"jg" = (
/obj/machinery/hydroponics/soil,
/obj/item/grown/corncob,
/turf/open/floor/plating/grass/jungle/lit,
/area/overmap_encounter/planetoid/jungle/explored)
"lN" = (
/obj/structure/table/wood,
/obj/item/grenade/chem_grenade/ez_clean{
	pixel_x = -4;
	pixel_y = 3
	},
/obj/item/grenade/chem_grenade/cleaner{
	pixel_x = 6;
	pixel_y = 7
	},
/obj/item/research_notes/loot/small{
	origin_type = "explosives";
	pixel_y = 4;
	value = 1200
	},
/turf/open/floor/wood,
/area/ruin/powered)
"nf" = (
/obj/structure/barricade/wooden,
/obj/machinery/door/airlock/wood{
	dir = 8
	},
/turf/open/floor/wood,
/area/ruin/powered)
"oD" = (
/turf/open/floor/wood{
	icon_state = "wood-broken"
	},
/area/ruin/powered)
"qe" = (
/obj/structure/fence{
	dir = 4
	},
/turf/open/floor/plating/grass/jungle/lit,
/area/overmap_encounter/planetoid/jungle/explored)
"qp" = (
/obj/structure/noticeboard{
	desc = "A board with many old marks and paper scraps on it.";
	dir = 4;
	name = "Teacher's Board"
	},
/turf/closed/wall/mineral/wood,
/area/ruin/powered)
"ri" = (
/obj/structure/chair/plastic{
	dir = 8
	},
/turf/open/floor/wood{
	icon_state = "wood-broken"
	},
/area/ruin/powered)
"rB" = (
/obj/structure/fence/corner{
	dir = 5
	},
/turf/open/floor/plating/grass/jungle/lit,
/area/overmap_encounter/planetoid/jungle/explored)
"rF" = (
/mob/living/simple_animal/hostile/asteroid/hivelord/legion/dwarf{
	desc = "You can still see what was once a rather small human under the shifting mass of corruption. Its trying to keep you away from the main office for some reason.";
	name = "Student"
	},
/turf/open/floor/wood,
/area/ruin/powered)
"rN" = (
/obj/structure/dresser,
/obj/item/research_notes/loot/medium{
	origin_type = "explosives";
	pixel_y = 6
	},
/turf/open/floor/wood{
	icon_state = "wood-broken5"
	},
/area/ruin/powered)
"sU" = (
/obj/machinery/hydroponics/soil,
/obj/item/reagent_containers/food/snacks/grown/corn,
/turf/open/floor/plating/grass/jungle/lit,
/area/overmap_encounter/planetoid/jungle/explored)
"sV" = (
/obj/structure/chair/comfy/black,
/turf/open/floor/carpet/red,
/area/ruin/powered)
"sX" = (
/obj/structure/bed,
/obj/item/bedsheet/rd,
/turf/open/floor/wood,
/area/ruin/powered)
"wq" = (
/obj/structure/table/wood,
/obj/item/grenade/firecracker{
	pixel_x = -8;
	pixel_y = -5
	},
/obj/item/grenade/firecracker{
	pixel_x = -8;
	pixel_y = 8
	},
/obj/item/grenade/firecracker{
	pixel_x = 4
	},
/turf/open/floor/wood,
/area/ruin/powered)
"wB" = (
/obj/item/seeds/corn/snapcorn,
/turf/open/floor/plating/grass/jungle/lit,
/area/overmap_encounter/planetoid/jungle/explored)
"wK" = (
/obj/structure/table/wood,
/obj/item/book/manual/wiki/grenades{
	desc = "Some kind of manual about making hellish grenades and explosives. Completely unreadable, but you feel as though you've gained a level in explosives.";
	name = "Pete's Lesson";
	pixel_y = 3
	},
/turf/open/floor/wood{
	icon_state = "wood-broken5"
	},
/area/ruin/powered)
"wT" = (
/obj/structure/barricade/wooden/crude,
/obj/machinery/door/airlock/wood{
	dir = 8
	},
/turf/open/floor/wood,
/area/ruin/powered)
"xs" = (
/obj/structure/table/wood/reinforced,
/obj/item/storage/belt/utility/chief/full,
/turf/open/floor/wood{
	icon_state = "wood-broken2"
	},
/area/ruin/powered)
"yu" = (
/turf/closed/wall/mineral/wood,
/area/ruin/powered)
"yJ" = (
/obj/structure/table/wood/reinforced,
/obj/item/grenade/clusterbuster/soap{
	name = "Reality Devastator"
	},
/turf/open/floor/wood,
/area/ruin/powered)
"yV" = (
/obj/item/grown/corncob,
/turf/open/floor/plating/grass/jungle/lit,
/area/overmap_encounter/planetoid/jungle/explored)
"zg" = (
/obj/item/transfer_valve{
	pixel_x = 7;
	pixel_y = 2
	},
/obj/item/transfer_valve{
	pixel_x = -8;
	pixel_y = 2
	},
/obj/structure/table/wood/fancy/orange,
/turf/open/floor/wood,
/area/ruin/powered)
"zX" = (
/obj/structure/flora/junglebush,
/turf/open/floor/plating/grass/jungle/lit,
/area/overmap_encounter/planetoid/jungle/explored)
"Bo" = (
/obj/machinery/light/broken/directional/south,
/turf/open/floor/wood,
/area/ruin/powered)
"Bz" = (
/obj/structure/closet/toolcloset,
/turf/open/floor/wood,
/area/ruin/powered)
"Cr" = (
/obj/structure/table/wood,
/obj/item/grenade/chem_grenade/large{
	pixel_x = -7;
	pixel_y = -1
	},
/obj/item/grenade/chem_grenade/large{
	pixel_x = 4;
	pixel_y = 9
	},
/obj/item/screwdriver/old{
	pixel_y = 10
	},
/turf/open/floor/wood,
/area/ruin/powered)
"DU" = (
/mob/living/simple_animal/hostile/asteroid/hivelord/legion{
	name = "Student"
	},
/turf/open/floor/wood{
	icon_state = "wood-broken7"
	},
/area/ruin/powered)
"Ej" = (
/obj/item/reagent_containers/food/snacks/grown/corn,
/turf/open/floor/plating/grass/jungle/lit,
/area/overmap_encounter/planetoid/jungle/explored)
"Fj" = (
/obj/structure/fence/cut/large{
	dir = 4
	},
/turf/open/floor/plating/grass/jungle/lit,
/area/overmap_encounter/planetoid/jungle/explored)
"FT" = (
/obj/machinery/light/small/directional/south,
/turf/open/floor/wood{
	icon_state = "wood-broken2"
	},
/area/ruin/powered)
"GE" = (
/obj/structure/chair/stool/bar{
	dir = 4;
	name = "teacher's stool"
	},
/turf/open/floor/wood,
/area/ruin/powered)
"Ho" = (
/obj/structure/table/wood/reinforced,
/obj/item/flashlight/lamp/green,
/turf/open/floor/wood,
/area/ruin/powered)
"Ht" = (
/obj/structure/flora/tree/jungle/small,
/turf/open/floor/plating/grass/jungle/lit,
/area/overmap_encounter/planetoid/jungle/explored)
"Iy" = (
/obj/structure/barricade/wooden,
/turf/open/floor/plating/grass/jungle/lit,
/area/overmap_encounter/planetoid/jungle/explored)
"Jd" = (
/obj/effect/mob_spawn/human/corpse/charredskeleton{
	desc = "Many die in the pursuit of science. Even more die making homebrew explosives in a random shack on some frontier planet.";
	name = "charred remains of the Teacher"
	},
/turf/open/floor/carpet/red,
/area/ruin/powered)
"Pr" = (
/obj/machinery/door/airlock/wood,
/turf/open/floor/wood,
/area/ruin/powered)
"PS" = (
/obj/structure/flora/rock,
/turf/open/floor/plating/grass/jungle/lit,
/area/overmap_encounter/planetoid/jungle/explored)
"Qo" = (
/turf/open/floor/plating/grass/jungle/lit,
/area/overmap_encounter/planetoid/jungle/explored)
"QZ" = (
/mob/living/simple_animal/hostile/cockroach/glockroach,
/turf/open/floor/plating/grass/jungle/lit,
/area/overmap_encounter/planetoid/jungle/explored)
"Rc" = (
/obj/structure/chair/plastic{
	dir = 8
	},
/turf/open/floor/wood{
	icon_state = "wood-broken7"
	},
/area/ruin/powered)
"RR" = (
/mob/living/simple_animal/hostile/rat{
	dir = 1
	},
/obj/machinery/light/small/directional/south,
/turf/open/floor/wood,
/area/ruin/powered)
"SG" = (
/obj/structure/flora/junglebush/large,
/turf/open/floor/plating/grass/jungle/lit,
/area/overmap_encounter/planetoid/jungle/explored)
"SI" = (
/obj/structure/table/wood,
/obj/item/grenade/stingbang{
	pixel_x = -5;
	pixel_y = 9
	},
/obj/item/lighter/greyscale{
	pixel_x = 6
	},
/turf/open/floor/wood{
	icon_state = "wood-broken2"
	},
/area/ruin/powered)
"TB" = (
/turf/open/floor/wood,
/area/ruin/powered)
"TQ" = (
/obj/structure/bookcase/random,
/turf/open/floor/wood{
	icon_state = "wood-broken2"
	},
/area/ruin/powered)
"Vq" = (
/obj/structure/table/wood/reinforced,
/obj/item/grenade/chem_grenade/adv_release{
	pixel_x = 6;
	pixel_y = 5
	},
/obj/item/grenade/chem_grenade/adv_release{
	pixel_x = -5;
	pixel_y = 5
	},
/obj/item/grenade/chem_grenade/adv_release{
	pixel_y = 5
	},
/turf/open/floor/wood{
	icon_state = "wood-broken"
	},
/area/ruin/powered)
"WW" = (
/obj/structure/table/wood,
/obj/item/clothing/mask/gas/welding,
/obj/item/research_notes/loot/small{
	origin_type = "explosives";
	pixel_y = 3;
	value = 1200
	},
/turf/open/floor/wood{
	icon_state = "wood-broken4"
	},
/area/ruin/powered)
"WY" = (
/obj/structure/barricade/wooden/crude,
/obj/machinery/door/airlock/wood,
/turf/open/floor/wood,
/area/ruin/powered)
"Xp" = (
/obj/structure/flora/tree/jungle,
/turf/open/floor/plating/grass/jungle/lit,
/area/overmap_encounter/planetoid/jungle/explored)
"XH" = (
/obj/machinery/light/small/directional/north,
/turf/open/floor/wood,
/area/ruin/powered)
"Ym" = (
/obj/item/tank/internals/plasma/full{
	pixel_x = -8;
	pixel_y = -1
	},
/obj/item/tank/internals/plasma/full{
	pixel_x = 5
	},
/obj/item/tank/internals/oxygen{
	pixel_x = -7;
	pixel_y = 8
	},
/obj/item/tank/internals/oxygen{
	pixel_x = 4;
	pixel_y = -6
	},
/obj/structure/table/wood/fancy/orange,
/turf/open/floor/wood{
	icon_state = "wood-broken5"
	},
/area/ruin/powered)
"Zo" = (
/turf/open/floor/wood{
	icon_state = "wood-broken4"
	},
/area/ruin/powered)

(1,1,1) = {"
Qo
zX
Qo
Qo
Qo
zX
SG
Qo
Qo
eS
Qo
Qo
Qo
Qo
zX
"}
(2,1,1) = {"
Qo
yu
yu
yu
yu
yu
yu
yu
yu
PS
Qo
Qo
Ht
eS
Qo
"}
(3,1,1) = {"
Xp
yu
sX
oD
bF
yu
zg
Ym
yu
yu
PS
Qo
Qo
zX
SG
"}
(4,1,1) = {"
Qo
yu
rN
eX
bM
Pr
eE
TB
Bz
yu
qp
qp
yu
yu
Qo
"}
(5,1,1) = {"
Qo
yu
dQ
Jd
RR
yu
oD
iH
Zo
aE
oD
GE
TQ
yu
Qo
"}
(6,1,1) = {"
Qo
yu
xs
sV
gI
yu
XH
Zo
rF
TB
TB
eE
TB
WY
eS
"}
(7,1,1) = {"
Qo
yu
Ho
Vq
yJ
yu
TB
TB
Zo
TB
eZ
Zo
oD
yu
Qo
"}
(8,1,1) = {"
Xp
yu
yu
yu
yu
yu
nf
wT
yu
lN
fu
wK
hD
yu
zX
"}
(9,1,1) = {"
Qo
qe
ic
Qo
yV
Qo
Qo
Iy
yu
yu
Rc
TB
oD
yu
Qo
"}
(10,1,1) = {"
SG
qe
Qo
fx
Qo
jg
eS
fx
Qo
yu
wq
SI
Bo
yu
Qo
"}
(11,1,1) = {"
Qo
Fj
Qo
dK
wB
dK
do
sU
Qo
yu
iS
TB
DU
yu
eS
"}
(12,1,1) = {"
Qo
qe
Qo
sU
Ej
dK
Qo
jg
ic
yu
WW
Cr
FT
yu
Qo
"}
(13,1,1) = {"
Qo
qe
yV
dK
QZ
fx
yV
sU
Qo
yu
TB
ri
TB
yu
Qo
"}
(14,1,1) = {"
Qo
rB
gd
gd
gd
gd
cc
gd
gd
yu
yu
yu
yu
yu
Qo
"}
(15,1,1) = {"
Qo
Qo
Qo
Xp
eS
Qo
Qo
zX
SG
Qo
Qo
Qo
Qo
Qo
zX
"}
