//MAP CONVERTED BY dmm2tgm.py THIS HEADER COMMENT PREVENTS RECONVERSION, DO NOT REMOVE
"aa" = (
/turf/template_noop,
/area/template_noop)
"ab" = (
/turf/open/floor/wood,
/area/ruin/unpowered)
"ac" = (
/obj/structure/closet/crate/coffin,
/obj/item/clothing/head/hooded/cloakhood/bone,
/turf/open/floor/plating/grass/jungle/lit,
/area/ruin/unpowered)
"ad" = (
/obj/structure/closet/crate/coffin,
/obj/item/reagent_containers/food/snacks/meat/slab/human/mutant/skeleton,
/turf/open/floor/plating/grass/jungle/lit,
/area/ruin/unpowered)
"ae" = (
/obj/structure/table/wood,
/obj/item/stack/sheet/mineral/wood,
/turf/open/floor/wood,
/area/ruin/unpowered)
"af" = (
/obj/structure/chair/wood/wings{
	dir = 1
	},
/turf/open/floor/wood,
/area/ruin/unpowered)
"ag" = (
/obj/structure/mineral_door/wood,
/obj/item/grown/bananapeel,
/obj/effect/decal/cleanable/dirt,
/turf/open/floor/plating/dirt/jungle/dark/lit,
/area/ruin/unpowered)
"ah" = (
/turf/open/floor/plating/grass/jungle/lit,
/area/ruin/unpowered)
"ai" = (
/obj/structure/closet/crate/coffin,
/turf/open/floor/plating/grass/jungle/lit,
/area/ruin/unpowered)
"aj" = (
/obj/structure/table/wood,
/obj/item/storage/toolbox/mechanical{
	pixel_x = -1;
	pixel_y = 2
	},
/turf/open/floor/wood,
/area/ruin/unpowered)
"ak" = (
/obj/item/reagent_containers/food/snacks/grown/banana,
/turf/open/floor/wood,
/area/ruin/unpowered)
"al" = (
/turf/closed/wall/mineral/wood,
/area/ruin/unpowered)
"am" = (
/obj/structure/closet/crate/coffin,
/obj/effect/mob_spawn/human/corpse/charredskeleton,
/turf/open/floor/plating/grass/jungle/lit,
/area/ruin/unpowered)
"an" = (
/obj/structure/table/wood,
/obj/item/flashlight/lamp/bananalamp,
/turf/open/floor/wood,
/area/ruin/unpowered)
"ao" = (
/obj/structure/flora/junglebush/c,
/turf/open/floor/plating/grass/jungle/lit,
/area/overmap_encounter/planetoid/jungle/explored)
"ap" = (
/obj/structure/flora/grass/jungle,
/turf/open/floor/plating/grass/jungle/lit,
/area/overmap_encounter/planetoid/jungle/explored)
"aq" = (
/obj/structure/closet/crate/coffin,
/obj/item/reagent_containers/food/snacks/meat/slab/human/mutant/skeleton,
/turf/open/floor/plating/dirt/jungle/dark/lit,
/area/ruin/unpowered)
"ar" = (
/obj/structure/flora/junglebush/c,
/turf/open/floor/plating/grass/jungle/lit,
/area/ruin/unpowered)
"as" = (
/obj/structure/sink/puddle,
/turf/open/floor/plating/grass/jungle/lit,
/area/ruin/unpowered)
"at" = (
/obj/structure/closet/crate/coffin,
/turf/open/floor/plating/grass/jungle/lit,
/area/overmap_encounter/planetoid/jungle/explored)
"au" = (
/obj/structure/closet/crate/coffin,
/obj/effect/decal/cleanable/dirt,
/turf/open/floor/wood,
/area/ruin/unpowered)
"av" = (
/turf/open/floor/plating/dirt/jungle/dark/lit,
/area/ruin/unpowered)
"aw" = (
/obj/structure/closet/crate/coffin,
/obj/effect/decal/cleanable/dirt,
/obj/item/cultivator/rake,
/obj/item/shovel,
/turf/open/floor/wood,
/area/ruin/unpowered)
"ax" = (
/obj/item/grown/bananapeel,
/turf/open/floor/wood,
/area/ruin/unpowered)
"ay" = (
/obj/structure/flora/junglebush/b,
/turf/open/floor/plating/grass/jungle/lit,
/area/ruin/unpowered)
"az" = (
/obj/structure/closet/cabinet,
/obj/item/clothing/head/pirate{
	pixel_y = -4
	},
/obj/item/clothing/suit/pirate{
	pixel_y = -4
	},
/obj/item/clothing/glasses/eyepatch{
	pixel_y = 2
	},
/turf/open/floor/wood,
/area/ruin/unpowered)
"aA" = (
/obj/effect/decal/cleanable/dirt,
/turf/open/floor/wood,
/area/ruin/unpowered)
"aB" = (
/obj/structure/closet/crate/coffin,
/obj/item/stack/sheet/bone,
/obj/item/stack/sheet/bone,
/obj/item/stack/sheet/bone,
/turf/open/floor/plating/grass/jungle/lit,
/area/ruin/unpowered)
"aC" = (
/obj/structure/closet/crate/coffin,
/obj/item/stack/sheet/bone,
/turf/open/floor/plating/grass/jungle/lit,
/area/ruin/unpowered)
"aD" = (
/turf/open/floor/plating/grass/jungle/lit,
/area/overmap_encounter/planetoid/jungle/explored)
"aE" = (
/obj/structure/closet/crate/coffin,
/obj/effect/decal/cleanable/dirt,
/obj/item/reagent_containers/food/snacks/sugarcookie/spookycoffin,
/obj/item/reagent_containers/food/snacks/sugarcookie/spookycoffin,
/obj/item/reagent_containers/food/snacks/sugarcookie/spookycoffin,
/turf/open/floor/wood,
/area/ruin/unpowered)
"aF" = (
/obj/item/reagent_containers/food/snacks/grown/banana,
/turf/open/floor/plating/dirt/jungle/dark/lit,
/area/ruin/unpowered)
"aG" = (
/obj/machinery/hydroponics/soil,
/turf/open/floor/plating/dirt/jungle/dark/lit,
/area/ruin/unpowered)
"aH" = (
/obj/structure/closet/crate/coffin,
/obj/effect/decal/cleanable/dirt,
/obj/item/reagent_containers/food/drinks/beer{
	pixel_x = 8
	},
/obj/item/reagent_containers/food/drinks/beer{
	pixel_x = -6
	},
/obj/item/reagent_containers/food/snacks/sugarcookie/spookycoffin,
/turf/open/floor/wood,
/area/ruin/unpowered)
"aI" = (
/obj/structure/table/wood,
/obj/item/melee/transforming/energy/sword/saber/pirate{
	pixel_x = 2;
	pixel_y = 3
	},
/obj/item/flashlight/lamp/bananalamp{
	pixel_x = 3;
	pixel_y = 9
	},
/turf/open/floor/wood,
/area/ruin/unpowered)
"aJ" = (
/obj/structure/closet/crate/coffin{
	desc = "It's a burial receptacle for some fruit.";
	name = "fridge"
	},
/obj/item/reagent_containers/food/snacks/grown/banana,
/obj/item/reagent_containers/food/snacks/grown/banana,
/obj/item/reagent_containers/food/snacks/grown/banana,
/obj/item/reagent_containers/food/snacks/grown/banana,
/obj/item/reagent_containers/food/snacks/grown/bungofruit,
/obj/effect/decal/cleanable/dirt,
/turf/open/floor/wood,
/area/ruin/unpowered)
"aK" = (
/obj/structure/closet/crate/coffin,
/obj/item/reagent_containers/food/snacks/monkeycube,
/turf/open/floor/plating/dirt/jungle/dark/lit,
/area/ruin/unpowered)
"aL" = (
/obj/structure/mineral_door/wood,
/turf/open/floor/wood,
/area/ruin/unpowered)
"aM" = (
/obj/structure/closet/crate/coffin,
/obj/item/stack/sheet/bone,
/obj/item/stack/sheet/bone,
/turf/open/floor/plating/grass/jungle/lit,
/area/ruin/unpowered)
"aN" = (
/obj/structure/closet/crate/coffin,
/obj/item/melee/baseball_bat/bone,
/turf/open/floor/plating/grass/jungle/lit,
/area/ruin/unpowered)
"aO" = (
/obj/structure/closet/crate/coffin,
/obj/effect/decal/remains/human,
/turf/open/floor/plating/grass/jungle/lit,
/area/overmap_encounter/planetoid/jungle/explored)
"aP" = (
/obj/structure/closet/crate/coffin,
/obj/effect/decal/cleanable/dirt,
/obj/item/clothing/suit/hooded/cloak/bone,
/turf/open/floor/wood,
/area/ruin/unpowered)
"aQ" = (
/obj/structure/closet/crate/coffin,
/obj/effect/decal/remains/human,
/turf/open/floor/plating/grass/jungle/lit,
/area/ruin/unpowered)
"aR" = (
/obj/structure/bed/dogbed{
	name = "Palmo's bed"
	},
/turf/open/floor/wood,
/area/ruin/unpowered)
"aS" = (
/obj/structure/table/wood,
/obj/item/paper{
	info = "Forgot I had this paper on me, so I might as well use it as a diary. Today is the 23rd of July, or atleast that's what I made up in my head, and I am currently fulfilling my dream career of carving coffins. Yep, I'm living my best life here. I tamed a monkey a while back, named him Palmo, little guy's been a dear friend since. Until activity picks up on this planet I'm just gonna live a nice and quiet life, and then sell my masterfully crafted coffins to all those in need of them. Also, I found some peculiar fruit earlier, tastes pretty good but I think I probably ingested a few of the seeds. Shouldn't be TOO bad for me. Either way, I'm going to go to bed. Hopefully I find some more paper to use so I can keep writing.";
	pixel_x = 3;
	pixel_y = 3
	},
/obj/item/pen{
	pixel_x = -5;
	pixel_y = 2
	},
/turf/open/floor/wood,
/area/ruin/unpowered)
"aT" = (
/obj/structure/flora/grass/jungle,
/turf/open/floor/plating/grass/jungle/lit,
/area/ruin/unpowered)
"aU" = (
/obj/structure/bed,
/obj/effect/decal/cleanable/dirt,
/obj/effect/mob_spawn/human/corpse/pirate{
	desc = "It looks like they died of a heart attack in their sleep."
	},
/turf/open/floor/wood,
/area/ruin/unpowered)
"aV" = (
/mob/living/carbon/monkey{
	dir = 8;
	name = "Palmo"
	},
/turf/open/floor/wood,
/area/ruin/unpowered)
"aW" = (
/obj/structure/closet/crate/coffin,
/obj/item/reagent_containers/food/snacks/sugarcookie/spookyskull,
/turf/open/floor/plating/grass/jungle/lit,
/area/ruin/unpowered)
"aX" = (
/obj/machinery/hydroponics/soil,
/turf/open/floor/plating/dirt/jungle/dark/lit,
/area/overmap_encounter/planetoid/jungle/explored)
"aY" = (
/obj/structure/closet/crate/coffin,
/obj/item/reagent_containers/glass/bucket/wooden,
/obj/item/seeds/banana,
/obj/item/seeds/banana,
/obj/effect/decal/cleanable/dirt,
/turf/open/floor/wood,
/area/ruin/unpowered)
"aZ" = (
/obj/structure/flora/junglebush,
/turf/open/floor/plating/grass/jungle/lit,
/area/ruin/unpowered)
"gN" = (
/obj/structure/closet/crate/coffin,
/obj/item/stack/sheet/bone,
/obj/item/stack/sheet/bone,
/obj/item/stack/sheet/bone,
/turf/open/floor/plating/grass/jungle/lit,
/area/overmap_encounter/planetoid/jungle/explored)
"iz" = (
/obj/structure/sink/puddle,
/turf/open/floor/plating/grass/jungle/lit,
/area/overmap_encounter/planetoid/jungle/explored)
"jJ" = (
/obj/item/grown/bananapeel,
/obj/effect/decal/cleanable/dirt,
/obj/machinery/door/airlock/wood,
/turf/open/floor/plating/dirt/jungle/dark/lit,
/area/ruin/unpowered)
"jP" = (
/obj/machinery/door/airlock/wood{
	dir = 8
	},
/turf/open/floor/wood,
/area/ruin/unpowered)
"qo" = (
/obj/structure/closet/crate/coffin,
/obj/item/reagent_containers/food/snacks/monkeycube,
/turf/open/floor/plating/dirt/jungle/dark/lit,
/area/overmap_encounter/planetoid/jungle/explored)
"ss" = (
/obj/structure/closet/crate/coffin,
/obj/item/stack/sheet/bone,
/obj/item/stack/sheet/bone,
/turf/open/floor/plating/grass/jungle/lit,
/area/overmap_encounter/planetoid/jungle/explored)
"uT" = (
/obj/structure/closet/crate/coffin,
/obj/item/reagent_containers/food/snacks/meat/slab/human/mutant/skeleton,
/turf/open/floor/plating/grass/jungle/lit,
/area/overmap_encounter/planetoid/jungle/explored)
"vX" = (
/obj/structure/closet/crate/coffin,
/obj/item/reagent_containers/food/snacks/meat/slab/human/mutant/skeleton,
/turf/open/floor/plating/dirt/jungle/dark/lit,
/area/overmap_encounter/planetoid/jungle/explored)
"yX" = (
/obj/structure/closet/crate/coffin,
/obj/item/clothing/head/hooded/cloakhood/bone,
/turf/open/floor/plating/grass/jungle/lit,
/area/overmap_encounter/planetoid/jungle/explored)
"zn" = (
/obj/structure/closet/crate/coffin,
/obj/item/reagent_containers/food/snacks/sugarcookie/spookyskull,
/turf/open/floor/plating/grass/jungle/lit,
/area/overmap_encounter/planetoid/jungle/explored)
"zp" = (
/obj/item/reagent_containers/food/snacks/grown/banana,
/turf/open/floor/plating/dirt/jungle/dark/lit,
/area/overmap_encounter/planetoid/jungle/explored)
"Fq" = (
/obj/structure/closet/crate/coffin,
/obj/effect/mob_spawn/human/corpse/charredskeleton,
/turf/open/floor/plating/grass/jungle/lit,
/area/overmap_encounter/planetoid/jungle/explored)
"FY" = (
/obj/structure/flora/junglebush,
/turf/open/floor/plating/grass/jungle/lit,
/area/overmap_encounter/planetoid/jungle/explored)
"LM" = (
/obj/structure/closet/crate/coffin,
/obj/item/melee/baseball_bat/bone,
/turf/open/floor/plating/grass/jungle/lit,
/area/overmap_encounter/planetoid/jungle/explored)
"NW" = (
/obj/structure/flora/junglebush/b,
/turf/open/floor/plating/grass/jungle/lit,
/area/overmap_encounter/planetoid/jungle/explored)
"Si" = (
/obj/structure/closet/crate/coffin,
/obj/item/stack/sheet/bone,
/turf/open/floor/plating/grass/jungle/lit,
/area/overmap_encounter/planetoid/jungle/explored)
"TD" = (
/turf/open/floor/plating/dirt/jungle/dark/lit,
/area/overmap_encounter/planetoid/jungle/explored)

(1,1,1) = {"
aa
aa
TD
TD
TD
TD
TD
NW
aa
aa
uT
aD
aD
at
aa
"}
(2,1,1) = {"
aa
TD
TD
al
al
al
al
ap
NW
aD
aD
aD
FY
aO
aa
"}
(3,1,1) = {"
aa
TD
al
al
aU
aI
al
al
ss
aD
at
aD
aD
aD
aa
"}
(4,1,1) = {"
aa
TD
al
az
ab
ab
aR
al
Si
aD
LM
aD
aD
at
aD
"}
(5,1,1) = {"
aa
qo
al
aH
ab
aA
aP
al
yX
aD
aD
aa
aa
aD
at
"}
(6,1,1) = {"
aa
al
al
al
jP
al
al
al
al
aD
aa
aa
aa
aa
aa
"}
(7,1,1) = {"
aa
al
aE
ax
ab
aA
ab
aw
al
zn
aa
aa
aa
aa
aa
"}
(8,1,1) = {"
aa
al
ae
ab
ab
ab
ax
aA
al
FY
aD
aD
aa
aa
aa
"}
(9,1,1) = {"
aa
al
aS
af
aV
aA
ab
aA
jJ
aD
aD
iz
aD
aD
aa
"}
(10,1,1) = {"
aa
al
aj
ax
aA
ab
ab
aY
al
Fq
ap
aD
TD
aX
aD
"}
(11,1,1) = {"
aa
al
al
ab
ab
ak
an
al
al
aD
aX
TD
aX
TD
ap
"}
(12,1,1) = {"
aa
aa
al
al
aJ
au
al
al
aa
gN
aX
zp
aX
vX
aD
"}
(13,1,1) = {"
aa
aa
aa
al
al
al
al
aa
aa
at
Si
aX
TD
aD
ao
"}
(14,1,1) = {"
aa
aa
aa
aa
aa
aa
aa
aa
aa
aa
aD
aD
aD
aD
aa
"}
