//MAP CONVERTED BY dmm2tgm.py THIS HEADER COMMENT PREVENTS RECONVERSION, DO NOT REMOVE
"aa" = (
/turf/closed/wall/mineral/wood,
/area/whitesands/surface/outdoors)
"ab" = (
/obj/effect/decal/cleanable/dirt,
/turf/open/floor/wood{
	icon_state = "wood-broken5"
	},
/area/whitesands/surface/outdoors)
"ac" = (
/obj/structure/table/reinforced,
/obj/item/pda/clear{
	pixel_x = 3;
	pixel_y = -3
	},
/obj/effect/decal/cleanable/dirt,
/turf/open/floor/wood,
/area/whitesands/surface/outdoors)
"ad" = (
/obj/structure/barricade/wooden,
/turf/open/floor/plating,
/area/whitesands/surface/outdoors)
"ae" = (
/obj/structure/rack,
/obj/effect/spawner/lootdrop/donkpockets,
/obj/effect/spawner/lootdrop/donkpockets,
/obj/effect/spawner/lootdrop/donkpockets,
/obj/effect/spawner/lootdrop/donkpockets,
/obj/effect/decal/cleanable/dirt,
/turf/open/floor/wood,
/area/whitesands/surface/outdoors)
"af" = (
/obj/structure/rack,
/obj/item/reagent_containers/food/snacks/cornchips,
/obj/item/reagent_containers/food/snacks/butterdog,
/obj/item/reagent_containers/food/snacks/candy,
/obj/item/reagent_containers/food/snacks/canned/peaches,
/obj/item/reagent_containers/food/drinks/bottle/sarsaparilla,
/turf/open/floor/wood,
/area/whitesands/surface/outdoors)
"ag" = (
/obj/effect/decal/cleanable/dirt,
/turf/open/floor/wood{
	icon_state = "wood-broken4"
	},
/area/whitesands/surface/outdoors)
"ah" = (
/obj/effect/decal/cleanable/dirt,
/obj/structure/barricade/wooden,
/turf/open/floor/plating,
/area/whitesands/surface/outdoors)
"ai" = (
/obj/structure/window,
/obj/structure/rack,
/obj/effect/decal/cleanable/dirt,
/turf/open/floor/wood,
/area/ruin/unpowered)
"aj" = (
/turf/closed/wall/mineral/wood,
/area/ruin/unpowered)
"ak" = (
/obj/structure/rack,
/obj/item/reagent_containers/food/snacks/cheesyfries,
/obj/item/reagent_containers/food/snacks/chips,
/obj/item/reagent_containers/food/snacks/cheesewedge,
/obj/effect/decal/cleanable/dirt,
/turf/open/floor/wood,
/area/whitesands/surface/outdoors)
"al" = (
/obj/structure/dresser,
/turf/open/floor/wood,
/area/whitesands/surface/outdoors)
"am" = (
/turf/open/floor/wood,
/area/whitesands/surface/outdoors)
"an" = (
/mob/living/simple_animal/hostile/asteroid/whitesands/survivor{
	dir = 4
	},
/turf/open/floor/wood{
	icon_state = "wood-broken7"
	},
/area/whitesands/surface/outdoors)
"ao" = (
/turf/open/floor/wood{
	icon_state = "wood-broken3"
	},
/area/whitesands/surface/outdoors)
"ap" = (
/obj/structure/table/reinforced,
/obj/item/paper_bin,
/obj/item/pen,
/obj/effect/decal/cleanable/dirt,
/turf/open/floor/wood{
	icon_state = "wood-broken7"
	},
/area/whitesands/surface/outdoors)
"aq" = (
/obj/machinery/door/window/northleft{
	dir = 8
	},
/obj/effect/decal/cleanable/dirt,
/turf/open/floor/wood,
/area/whitesands/surface/outdoors)
"ar" = (
/obj/structure/rack,
/obj/item/gun/energy/kinetic_accelerator{
	pixel_x = 3;
	pixel_y = -3
	},
/obj/item/gun/energy/kinetic_accelerator{
	pixel_x = -3;
	pixel_y = 3
	},
/turf/open/floor/wood,
/area/whitesands/surface/outdoors)
"as" = (
/obj/structure/sign/poster/official/pda_ad,
/turf/closed/wall/mineral/wood,
/area/whitesands/surface/outdoors)
"at" = (
/obj/structure/rack,
/obj/effect/spawner/lootdrop/minor/kittyears_or_rabbitears,
/obj/effect/spawner/lootdrop/minor/kittyears_or_rabbitears,
/turf/open/floor/wood,
/area/whitesands/surface/outdoors)
"au" = (
/obj/structure/table/reinforced,
/obj/effect/decal/cleanable/dirt,
/turf/open/floor/wood,
/area/whitesands/surface/outdoors)
"av" = (
/obj/effect/spawner/lootdrop/costume,
/obj/structure/window,
/obj/structure/rack,
/turf/open/floor/wood,
/area/ruin/unpowered)
"aw" = (
/obj/structure/window,
/obj/structure/rack,
/obj/effect/decal/cleanable/dirt,
/turf/open/floor/wood,
/area/whitesands/surface/outdoors)
"ax" = (
/obj/structure/mineral_door/wood,
/turf/open/floor/wood,
/area/whitesands/surface/outdoors)
"ay" = (
/obj/structure/rack,
/obj/item/grenade/smokebomb{
	pixel_x = 5
	},
/obj/item/grenade/smokebomb{
	pixel_x = -6
	},
/turf/open/floor/wood,
/area/whitesands/surface/outdoors)
"az" = (
/turf/open/floor/wood{
	icon_state = "wood-broken5"
	},
/area/whitesands/surface/outdoors)
"aA" = (
/obj/machinery/vending/cola/random,
/obj/machinery/light{
	dir = 8
	},
/turf/open/floor/wood,
/area/whitesands/surface/outdoors)
"aB" = (
/turf/open/floor/wood{
	icon_state = "wood-broken4"
	},
/area/whitesands/surface/outdoors)
"aC" = (
/obj/structure/mineral_door/wood,
/obj/effect/decal/cleanable/dirt,
/turf/open/floor/wood,
/area/whitesands/surface/outdoors)
"aD" = (
/turf/open/floor/wood{
	icon_state = "wood-broken"
	},
/area/whitesands/surface/outdoors)
"aE" = (
/obj/effect/spawner/lootdrop/costume,
/obj/effect/spawner/lootdrop/gloves,
/obj/structure/window,
/obj/structure/rack,
/turf/open/floor/wood,
/area/whitesands/surface/outdoors)
"aF" = (
/obj/structure/rack,
/obj/item/borg/upgrade/modkit/cooldown{
	pixel_x = 7;
	pixel_y = 5
	},
/obj/item/borg/upgrade/modkit/damage,
/obj/item/borg/upgrade/modkit/range{
	pixel_x = -7
	},
/turf/open/floor/wood,
/area/whitesands/surface/outdoors)
"aG" = (
/obj/effect/spawner/lootdrop/costume,
/obj/structure/window,
/obj/structure/rack,
/turf/open/floor/wood,
/area/whitesands/surface/outdoors)
"aH" = (
/obj/effect/decal/cleanable/dirt,
/turf/open/floor/wood{
	icon_state = "wood-broken7"
	},
/area/whitesands/surface/outdoors)
"aI" = (
/obj/effect/decal/cleanable/dirt,
/turf/open/floor/wood{
	icon_state = "wood-broken2"
	},
/area/whitesands/surface/outdoors)
"aJ" = (
/obj/structure/rack,
/obj/item/reagent_containers/food/snacks/chewable/bubblegum/nicotine,
/obj/item/reagent_containers/food/snacks/burger/fivealarm,
/obj/item/reagent_containers/food/snacks/cherrycupcake,
/turf/open/floor/wood,
/area/whitesands/surface/outdoors)
"aK" = (
/obj/structure/rack,
/obj/item/reagent_containers/food/snacks/chococornet,
/obj/item/reagent_containers/food/snacks/candy,
/obj/item/reagent_containers/food/snacks/canned/peaches,
/turf/open/floor/wood,
/area/whitesands/surface/outdoors)
"aL" = (
/obj/effect/spawner/lootdrop/costume,
/obj/effect/spawner/lootdrop/gloves,
/obj/item/shard{
	icon_state = "tiny"
	},
/obj/item/shard{
	icon_state = "medium"
	},
/turf/open/floor/wood,
/area/ruin/unpowered)
"aM" = (
/obj/effect/spawner/lootdrop/costume,
/obj/effect/spawner/lootdrop/gloves,
/obj/item/shard{
	icon_state = "tiny"
	},
/obj/item/shard{
	icon_state = "medium"
	},
/turf/open/floor/wood,
/area/whitesands/surface/outdoors)
"aN" = (
/obj/structure/bed,
/obj/item/bedsheet/dorms,
/turf/open/floor/wood,
/area/whitesands/surface/outdoors)
"aO" = (
/obj/structure/rack,
/obj/item/reagent_containers/food/snacks/chewable/bubblegum/happiness,
/obj/item/reagent_containers/food/snacks/candy_corn,
/obj/item/reagent_containers/food/snacks/chocolatebar,
/obj/effect/decal/cleanable/dirt,
/turf/open/floor/wood,
/area/whitesands/surface/outdoors)
"aP" = (
/obj/effect/decal/cleanable/dirt,
/obj/structure/barricade/wooden,
/turf/open/floor/plating,
/area/ruin/unpowered)
"aQ" = (
/obj/structure/rack,
/obj/item/reagent_containers/food/snacks/chocolatebunny,
/obj/item/reagent_containers/food/snacks/candy,
/obj/item/reagent_containers/food/snacks/canned/beans,
/obj/effect/decal/cleanable/dirt,
/obj/machinery/light{
	dir = 1
	},
/turf/open/floor/wood,
/area/whitesands/surface/outdoors)
"aR" = (
/obj/structure/rack,
/obj/item/reagent_containers/food/snacks/cheesynachos,
/obj/item/reagent_containers/food/snacks/branrequests,
/obj/item/reagent_containers/food/snacks/canned/beans,
/obj/item/reagent_containers/food/drinks/bottle/sarsaparilla,
/turf/open/floor/wood,
/area/whitesands/surface/outdoors)
"aS" = (
/turf/template_noop,
/area/template_noop)
"aT" = (
/obj/effect/spawner/lootdrop/costume,
/obj/effect/spawner/lootdrop/gloves,
/obj/structure/window,
/obj/structure/rack,
/turf/open/floor/wood,
/area/ruin/unpowered)
"aU" = (
/obj/effect/decal/cleanable/dirt,
/turf/open/floor/wood,
/area/whitesands/surface/outdoors)
"aV" = (
/obj/structure/table/reinforced,
/obj/item/pen/red,
/obj/effect/decal/cleanable/dirt,
/turf/open/floor/wood,
/area/whitesands/surface/outdoors)
"aW" = (
/obj/structure/rack,
/obj/item/construction/rcd{
	pixel_x = -3;
	pixel_y = 3
	},
/obj/item/rcd_ammo,
/turf/open/floor/wood,
/area/whitesands/surface/outdoors)
"aX" = (
/obj/structure/closet/cabinet,
/obj/item/stack/spacecash/c100,
/obj/item/stack/spacecash/c10,
/obj/item/stack/spacecash/c1,
/obj/item/stack/spacecash/c1,
/obj/item/stack/spacecash/c1,
/obj/item/stack/spacecash/c1,
/obj/item/stack/spacecash/c1,
/obj/item/stack/spacecash/c20,
/obj/item/stack/spacecash/c200,
/obj/item/stack/spacecash/c50,
/turf/open/floor/wood,
/area/whitesands/surface/outdoors)
"aY" = (
/obj/machinery/light{
	dir = 1
	},
/turf/open/floor/wood,
/area/whitesands/surface/outdoors)
"aZ" = (
/turf/open/floor/plating,
/area/whitesands/surface/outdoors)
"dN" = (
/turf/open/floor/wood{
	icon_state = "wood-broken"
	},
/area/ruin/unpowered)
"eh" = (
/obj/structure/bed,
/obj/item/bedsheet/dorms,
/turf/open/floor/wood,
/area/ruin/unpowered)
"fn" = (
/turf/open/floor/wood{
	icon_state = "wood-broken4"
	},
/area/ruin/unpowered)
"gm" = (
/obj/structure/table/reinforced,
/obj/item/paper_bin,
/obj/item/pen,
/obj/effect/decal/cleanable/dirt,
/turf/open/floor/wood{
	icon_state = "wood-broken7"
	},
/area/ruin/unpowered)
"hc" = (
/obj/structure/rack,
/obj/effect/spawner/lootdrop/minor/kittyears_or_rabbitears,
/obj/effect/spawner/lootdrop/minor/kittyears_or_rabbitears,
/turf/open/floor/wood,
/area/ruin/unpowered)
"jV" = (
/obj/structure/rack,
/obj/item/reagent_containers/food/snacks/cheesynachos,
/obj/item/reagent_containers/food/snacks/branrequests,
/obj/item/reagent_containers/food/snacks/canned/beans,
/obj/item/reagent_containers/food/drinks/bottle/sarsaparilla,
/turf/open/floor/wood,
/area/ruin/unpowered)
"jY" = (
/obj/structure/sign/poster/official/pda_ad,
/turf/closed/wall/mineral/wood,
/area/ruin/unpowered)
"ko" = (
/obj/structure/rack,
/obj/item/reagent_containers/food/snacks/cornchips,
/obj/item/reagent_containers/food/snacks/butterdog,
/obj/item/reagent_containers/food/snacks/candy,
/obj/item/reagent_containers/food/snacks/canned/peaches,
/obj/item/reagent_containers/food/drinks/bottle/sarsaparilla,
/turf/open/floor/wood,
/area/ruin/unpowered)
"os" = (
/obj/effect/decal/cleanable/dirt,
/turf/open/floor/wood{
	icon_state = "wood-broken7"
	},
/area/ruin/unpowered)
"qK" = (
/obj/effect/decal/cleanable/dirt,
/turf/open/floor/wood{
	icon_state = "wood-broken5"
	},
/area/ruin/unpowered)
"sm" = (
/obj/structure/rack,
/obj/item/borg/upgrade/modkit/cooldown{
	pixel_x = 7;
	pixel_y = 5
	},
/obj/item/borg/upgrade/modkit/damage,
/obj/item/borg/upgrade/modkit/range{
	pixel_x = -7
	},
/turf/open/floor/wood,
/area/ruin/unpowered)
"sV" = (
/obj/machinery/vending/cola/random,
/obj/machinery/light/directional/west,
/turf/open/floor/wood,
/area/ruin/unpowered)
"ta" = (
/obj/structure/rack,
/obj/item/reagent_containers/food/snacks/cheesyfries,
/obj/item/reagent_containers/food/snacks/chips,
/obj/item/reagent_containers/food/snacks/cheesewedge,
/obj/effect/decal/cleanable/dirt,
/turf/open/floor/wood,
/area/ruin/unpowered)
"tx" = (
/obj/machinery/door/window/northleft{
	dir = 8
	},
/obj/effect/decal/cleanable/dirt,
/turf/open/floor/wood,
/area/ruin/unpowered)
"tQ" = (
/obj/effect/decal/cleanable/dirt,
/turf/open/floor/wood{
	icon_state = "wood-broken2"
	},
/area/ruin/unpowered)
"uk" = (
/obj/effect/decal/cleanable/dirt,
/turf/open/floor/wood{
	icon_state = "wood-broken4"
	},
/area/ruin/unpowered)
"uP" = (
/obj/structure/mineral_door/wood,
/obj/effect/decal/cleanable/dirt,
/turf/open/floor/wood,
/area/ruin/unpowered)
"wM" = (
/obj/structure/rack,
/obj/item/reagent_containers/food/snacks/chewable/bubblegum/happiness,
/obj/item/reagent_containers/food/snacks/candy_corn,
/obj/item/reagent_containers/food/snacks/chocolatebar,
/obj/effect/decal/cleanable/dirt,
/turf/open/floor/wood,
/area/ruin/unpowered)
"xb" = (
/obj/structure/rack,
/obj/item/reagent_containers/food/snacks/chococornet,
/obj/item/reagent_containers/food/snacks/candy,
/obj/item/reagent_containers/food/snacks/canned/peaches,
/turf/open/floor/wood,
/area/ruin/unpowered)
"xE" = (
/obj/structure/rack,
/obj/item/construction/rcd{
	pixel_x = -3;
	pixel_y = 3
	},
/obj/item/rcd_ammo,
/turf/open/floor/wood,
/area/ruin/unpowered)
"yf" = (
/obj/structure/dresser,
/turf/open/floor/wood,
/area/ruin/unpowered)
"yX" = (
/turf/open/floor/wood,
/area/ruin/unpowered)
"zb" = (
/turf/open/floor/wood{
	icon_state = "wood-broken3"
	},
/area/ruin/unpowered)
"zB" = (
/obj/structure/rack,
/obj/item/gun/energy/kinetic_accelerator{
	pixel_x = 3;
	pixel_y = -3
	},
/obj/item/gun/energy/kinetic_accelerator{
	pixel_x = -3;
	pixel_y = 3
	},
/turf/open/floor/wood,
/area/ruin/unpowered)
"CA" = (
/obj/machinery/light/directional/north,
/turf/open/floor/wood,
/area/ruin/unpowered)
"DK" = (
/obj/effect/decal/cleanable/dirt,
/turf/open/floor/wood,
/area/ruin/unpowered)
"Fi" = (
/obj/structure/rack,
/obj/item/reagent_containers/food/snacks/chocolatebunny,
/obj/item/reagent_containers/food/snacks/candy,
/obj/item/reagent_containers/food/snacks/canned/beans,
/obj/effect/decal/cleanable/dirt,
/obj/machinery/light/directional/north,
/turf/open/floor/wood,
/area/ruin/unpowered)
"Ft" = (
/obj/structure/rack,
/obj/item/reagent_containers/food/snacks/chewable/bubblegum/nicotine,
/obj/item/reagent_containers/food/snacks/burger/fivealarm,
/obj/item/reagent_containers/food/snacks/cherrycupcake,
/turf/open/floor/wood,
/area/ruin/unpowered)
"GN" = (
/obj/structure/table/reinforced,
/obj/item/pda/clear{
	pixel_x = 3;
	pixel_y = -3
	},
/obj/effect/decal/cleanable/dirt,
/turf/open/floor/wood,
/area/ruin/unpowered)
"Hj" = (
/obj/structure/mineral_door/wood,
/turf/open/floor/wood,
/area/ruin/unpowered)
"Ih" = (
/obj/structure/barricade/wooden,
/turf/open/floor/plating,
/area/ruin/unpowered)
"Jw" = (
/mob/living/simple_animal/hostile/asteroid/whitesands/survivor{
	dir = 4
	},
/turf/open/floor/wood{
	icon_state = "wood-broken7"
	},
/area/ruin/unpowered)
"JT" = (
/obj/structure/rack,
/obj/effect/spawner/lootdrop/donkpockets,
/obj/effect/spawner/lootdrop/donkpockets,
/obj/effect/spawner/lootdrop/donkpockets,
/obj/effect/spawner/lootdrop/donkpockets,
/obj/effect/decal/cleanable/dirt,
/turf/open/floor/wood,
/area/ruin/unpowered)
"RI" = (
/obj/structure/closet/cabinet,
/obj/item/spacecash/bundle/c100,
/obj/item/spacecash/bundle/c10,
/obj/item/spacecash/bundle/c1,
/obj/item/spacecash/bundle/c1,
/obj/item/spacecash/bundle/c1,
/obj/item/spacecash/bundle/c1,
/obj/item/spacecash/bundle/c1,
/obj/item/spacecash/bundle/c20,
/obj/item/spacecash/bundle/c200,
/obj/item/spacecash/bundle/c50,
/turf/open/floor/wood,
/area/ruin/unpowered)
"UQ" = (
/turf/open/floor/wood{
	icon_state = "wood-broken5"
	},
/area/ruin/unpowered)
"Vz" = (
/obj/structure/table/reinforced,
/obj/effect/decal/cleanable/dirt,
/turf/open/floor/wood,
/area/ruin/unpowered)
"WJ" = (
/obj/structure/rack,
/obj/item/grenade/smokebomb{
	pixel_x = 5
	},
/obj/item/grenade/smokebomb{
	pixel_x = -6
	},
/turf/open/floor/wood,
/area/ruin/unpowered)
"Xf" = (
/obj/structure/table/reinforced,
/obj/item/pen/red,
/obj/effect/decal/cleanable/dirt,
/turf/open/floor/wood,
/area/ruin/unpowered)
"Xu" = (
/turf/open/floor/plating,
/area/ruin/unpowered)

(1,1,1) = {"
aj
Ih
Xu
Xu
Ih
aj
aj
"}
(2,1,1) = {"
Xu
jV
os
ta
xb
sV
aP
"}
(3,1,1) = {"
aj
wM
Jw
os
qK
zb
aT
"}
(4,1,1) = {"
aj
Fi
dN
ko
Ft
os
ai
"}
(5,1,1) = {"
Ih
GN
tx
Vz
DK
UQ
aL
"}
(6,1,1) = {"
Ih
zB
zb
gm
fn
DK
av
"}
(7,1,1) = {"
jY
sm
os
Xf
qK
JT
aj
"}
(8,1,1) = {"
aj
xE
uk
Vz
tQ
yX
uP
"}
(9,1,1) = {"
Ih
WJ
DK
Vz
DK
hc
Ih
"}
(10,1,1) = {"
aj
aj
Hj
aj
aj
Ih
aj
"}
(11,1,1) = {"
aj
yX
yX
yX
aj
aS
aS
"}
(12,1,1) = {"
aj
CA
yX
yX
aj
aS
aS
"}
(13,1,1) = {"
aj
eh
RI
yf
aj
aS
aS
"}
(14,1,1) = {"
aj
aj
aj
aj
aj
aS
aS
"}
