//MAP CONVERTED BY dmm2tgm.py THIS HEADER COMMENT PREVENTS RECONVERSION, DO NOT REMOVE
"ah" = (
/obj/item/resonator/upgraded,
/obj/effect/mob_spawn/human/corpse{
	mob_species = /datum/species/golem
	},
/obj/effect/decal/cleanable/blood/old,
/turf/open/floor/plating{
	icon_state = "panelscorched"
	},
/area/ruin/unpowered)
"ai" = (
/obj/structure/rack,
/obj/item/card/id/mining,
/obj/item/clothing/head/hardhat/mining,
/turf/open/floor/plating{
	icon_state = "platingdmg1"
	},
/area/overmap_encounter/planetoid/sand/explored)
"au" = (
/obj/item/storage/box,
/obj/structure/table,
/obj/item/light/bulb/broken,
/obj/item/light/tube/broken{
	pixel_x = -1;
	pixel_y = 5
	},
/obj/item/shard,
/obj/effect/mob_spawn/human/corpse{
	mob_species = /datum/species/lizard/ashwalker
	},
/obj/effect/decal/cleanable/blood/old,
/turf/open/floor/plasteel/dark,
/area/ruin/unpowered)
"ba" = (
/obj/machinery/shower,
/obj/effect/decal/cleanable/dirt,
/turf/open/floor/plasteel/freezer,
/area/overmap_encounter/planetoid/sand/explored)
"bD" = (
/obj/effect/decal/cleanable/dirt,
/turf/open/floor/plating{
	icon_state = "platingdmg1"
	},
/area/overmap_encounter/planetoid/sand/explored)
"bL" = (
/obj/effect/turf_decal/corner/transparent/neutral{
	dir = 1
	},
/obj/effect/turf_decal/corner/transparent/neutral{
	dir = 8
	},
/obj/effect/turf_decal/trimline/opaque/white/corner{
	dir = 4
	},
/obj/effect/decal/cleanable/dirt,
/obj/effect/turf_decal/trimline/opaque/white/corner,
/turf/open/floor/plasteel/dark,
/area/ruin/unpowered)
"bX" = (
/obj/structure/girder,
/turf/open/floor/plating,
/area/ruin/unpowered)
"cn" = (
/obj/effect/decal/cleanable/dirt,
/turf/open/floor/plating{
	icon_state = "platingdmg1"
	},
/area/ruin/unpowered)
"cD" = (
/turf/closed/wall/mineral/titanium/nodiagonal,
/area/ruin/unpowered)
"cF" = (
/turf/open/floor/plating{
	icon_state = "platingdmg1"
	},
/area/overmap_encounter/planetoid/sand/explored)
"dd" = (
/obj/effect/turf_decal/trimline/opaque/purple/line{
	dir = 5
	},
/obj/effect/turf_decal/trimline/opaque/purple/corner{
	dir = 8
	},
/obj/item/shard{
	icon_state = "tiny"
	},
/obj/item/shard{
	icon_state = "small"
	},
/obj/effect/mob_spawn/human/corpse{
	mob_species = /datum/species/golem
	},
/turf/open/floor/plasteel/dark,
/area/ruin/unpowered)
"dm" = (
/turf/closed/wall/mineral/plastitanium,
/area/ruin/unpowered)
"eh" = (
/turf/open/floor/mineral/titanium/purple,
/area/ruin/unpowered)
"fh" = (
/obj/item/shard{
	icon_state = "medium"
	},
/turf/open/floor/plating/asteroid/whitesands,
/area/overmap_encounter/planetoid/sand/explored)
"gg" = (
/obj/item/stack/sheet/mineral/wood,
/obj/item/stack/sheet/mineral/wood,
/obj/item/stack/sheet/mineral/wood,
/obj/item/stack/sheet/mineral/wood,
/obj/item/mining_scanner{
	pixel_x = -7;
	pixel_y = 5
	},
/turf/open/floor/mineral/plastitanium,
/area/overmap_encounter/planetoid/sand/explored)
"gt" = (
/obj/effect/decal/cleanable/dirt,
/turf/open/floor/plasteel,
/area/ruin/unpowered)
"gz" = (
/obj/item/mining_scanner,
/turf/open/floor/plating{
	icon_state = "platingdmg1"
	},
/area/overmap_encounter/planetoid/sand/explored)
"hI" = (
/turf/open/floor/plating{
	icon_state = "platingdmg2"
	},
/area/ruin/unpowered)
"hY" = (
/obj/effect/turf_decal/corner/transparent/neutral{
	dir = 8
	},
/obj/effect/turf_decal/trimline/opaque/white/line{
	dir = 5
	},
/obj/effect/decal/cleanable/dirt,
/turf/open/floor/plasteel/dark,
/area/ruin/unpowered)
"ib" = (
/obj/structure/rack,
/obj/item/storage/toolbox/electrical{
	pixel_x = -3;
	pixel_y = 3
	},
/obj/item/storage/toolbox/mechanical,
/obj/item/storage/toolbox/emergency{
	pixel_x = 3;
	pixel_y = -3
	},
/turf/open/floor/plating{
	icon_state = "platingdmg1"
	},
/area/ruin/unpowered)
"id" = (
/obj/structure/girder/displaced,
/turf/open/floor/plating,
/area/ruin/unpowered)
"iJ" = (
/obj/item/storage/part_replacer/bluespace/tier2,
/turf/open/floor/mineral/titanium/white,
/area/ruin/unpowered)
"iO" = (
/obj/item/pickaxe{
	pixel_x = 3;
	pixel_y = -3
	},
/obj/item/card/id/mining,
/obj/effect/decal/cleanable/dirt,
/turf/open/floor/mineral/titanium/yellow,
/area/overmap_encounter/planetoid/sand/explored)
"iX" = (
/obj/structure/shuttle/engine/heater{
	dir = 1
	},
/obj/structure/window/reinforced,
/turf/open/floor/plating,
/area/ruin/unpowered)
"iY" = (
/obj/structure/rack,
/obj/effect/turf_decal/trimline/opaque/yellow/line{
	dir = 8
	},
/obj/effect/turf_decal/corner/transparent/neutral{
	dir = 4
	},
/obj/effect/turf_decal/corner/transparent/neutral,
/obj/effect/turf_decal/industrial/outline/yellow,
/obj/item/clothing/head/hardhat/mining{
	pixel_x = -6;
	pixel_y = -6
	},
/obj/item/clothing/head/hardhat/mining{
	pixel_x = -2;
	pixel_y = -2
	},
/obj/item/clothing/head/hardhat/mining{
	pixel_x = 6;
	pixel_y = 6
	},
/turf/open/floor/mineral/plastitanium,
/area/overmap_encounter/planetoid/sand/explored)
"je" = (
/obj/structure/girder,
/turf/open/floor/plating,
/area/overmap_encounter/planetoid/sand/explored)
"jf" = (
/obj/item/pickaxe,
/turf/open/floor/plating,
/area/ruin/unpowered)
"jk" = (
/obj/item/resonator,
/obj/effect/decal/cleanable/blood/old,
/turf/open/floor/plating{
	icon_state = "platingdmg1"
	},
/area/ruin/unpowered)
"jN" = (
/obj/effect/decal/cleanable/dirt,
/turf/open/floor/plasteel/freezer,
/area/overmap_encounter/planetoid/sand/explored)
"kw" = (
/obj/machinery/washing_machine,
/turf/open/floor/plating{
	icon_state = "platingdmg1"
	},
/area/ruin/unpowered)
"kU" = (
/obj/structure/frame/machine,
/obj/effect/decal/cleanable/oil,
/obj/item/stack/cable_coil/cut/random,
/obj/item/clothing/suit/space/hardsuit/mining,
/turf/open/floor/plating{
	icon_state = "platingdmg1"
	},
/area/ruin/unpowered)
"lc" = (
/obj/machinery/door/airlock/titanium,
/turf/open/floor/plating/asteroid/whitesands,
/area/ruin/unpowered)
"mX" = (
/obj/structure/AIcore/deactivated,
/turf/open/floor/mineral/titanium/white,
/area/ruin/unpowered)
"ni" = (
/obj/item/rack_parts,
/turf/open/floor/plating/asteroid/whitesands,
/area/overmap_encounter/planetoid/sand/explored)
"nl" = (
/obj/item/shard,
/obj/effect/turf_decal/corner/transparent/neutral{
	dir = 4
	},
/obj/effect/turf_decal/corner/transparent/neutral,
/obj/effect/turf_decal/trimline/opaque/purple/line{
	dir = 8
	},
/obj/effect/decal/cleanable/dirt,
/turf/open/floor/plasteel/dark,
/area/ruin/unpowered)
"nD" = (
/obj/structure/rack,
/obj/item/spear,
/obj/item/shard{
	icon_state = "medium"
	},
/obj/item/shard{
	icon_state = "tiny"
	},
/obj/item/shard{
	icon_state = "small"
	},
/turf/open/floor/plasteel/dark,
/area/ruin/unpowered)
"pj" = (
/obj/effect/decal/cleanable/dirt,
/turf/open/floor/mineral/titanium/purple,
/area/ruin/unpowered)
"pD" = (
/obj/effect/decal/cleanable/oil/streak,
/obj/effect/decal/cleanable/dirt,
/turf/open/floor/plasteel,
/area/ruin/unpowered)
"pR" = (
/obj/item/mining_scanner{
	pixel_y = 7
	},
/obj/effect/decal/cleanable/dirt,
/turf/open/floor/mineral/titanium/yellow,
/area/overmap_encounter/planetoid/sand/explored)
"qa" = (
/obj/structure/reagent_dispensers/watertank,
/turf/open/floor/plating,
/area/ruin/unpowered)
"qw" = (
/obj/structure/door_assembly/door_assembly_com,
/turf/open/floor/plating{
	icon_state = "platingdmg1"
	},
/area/ruin/unpowered)
"qD" = (
/obj/item/light/bulb/broken{
	pixel_x = -4;
	pixel_y = -4
	},
/obj/effect/decal/cleanable/dirt,
/turf/open/floor/plasteel,
/area/ruin/unpowered)
"qE" = (
/obj/machinery/door/airlock/titanium,
/turf/open/floor/plating,
/area/ruin/unpowered)
"qZ" = (
/obj/structure/girder/displaced,
/turf/open/floor/plating{
	icon_state = "panelscorched"
	},
/area/overmap_encounter/planetoid/sand/explored)
"rA" = (
/turf/open/floor/plating{
	icon_state = "platingdmg2"
	},
/area/overmap_encounter/planetoid/sand/explored)
"sw" = (
/obj/item/rack_parts,
/turf/open/floor/mineral/plastitanium,
/area/overmap_encounter/planetoid/sand/explored)
"sJ" = (
/obj/structure/shuttle/engine/propulsion{
	dir = 1
	},
/turf/open/floor/plating,
/area/ruin/unpowered)
"sM" = (
/obj/structure/frame/machine,
/turf/open/floor/plating,
/area/ruin/unpowered)
"sY" = (
/turf/open/floor/plasteel/dark,
/area/ruin/unpowered)
"th" = (
/obj/effect/mob_spawn/human/corpse{
	mob_species = /datum/species/golem
	},
/obj/effect/decal/cleanable/dirt,
/obj/effect/decal/cleanable/blood/old,
/turf/open/floor/mineral/titanium/white,
/area/ruin/unpowered)
"tC" = (
/obj/effect/spawner/structure/window/shuttle,
/turf/open/floor/plating,
/area/ruin/unpowered)
"ur" = (
/obj/structure/girder/displaced,
/turf/open/floor/plating{
	icon_state = "platingdmg1"
	},
/area/ruin/unpowered)
"uz" = (
/obj/structure/frame/machine,
/obj/effect/decal/cleanable/dirt,
/turf/open/floor/plasteel/dark,
/area/ruin/unpowered)
"vb" = (
/obj/item/light/tube/broken{
	pixel_x = -10;
	pixel_y = -7
	},
/turf/open/floor/plating{
	icon_state = "panelscorched"
	},
/area/ruin/unpowered)
"vg" = (
/obj/item/light/bulb/broken{
	pixel_x = 3;
	pixel_y = -1
	},
/turf/open/floor/plating{
	icon_state = "platingdmg1"
	},
/area/ruin/unpowered)
"vo" = (
/obj/item/resonator,
/obj/effect/mob_spawn/human/corpse{
	mob_species = /datum/species/golem
	},
/obj/effect/decal/cleanable/dirt,
/obj/effect/decal/cleanable/blood/old,
/turf/open/floor/mineral/titanium/purple,
/area/ruin/unpowered)
"vq" = (
/obj/structure/frame/machine,
/obj/item/shard,
/obj/item/book/manual/wiki/research_and_development{
	name = "Sacred Text of the Liberator";
	pixel_y = -5
	},
/turf/open/floor/plating{
	icon_state = "platingdmg1"
	},
/area/ruin/unpowered)
"xe" = (
/obj/effect/decal/cleanable/dirt,
/turf/open/floor/plating,
/area/ruin/unpowered)
"xK" = (
/obj/structure/reagent_dispensers/fueltank,
/obj/effect/decal/cleanable/oil/slippery,
/turf/open/floor/plasteel/dark,
/area/ruin/unpowered)
"yg" = (
/obj/effect/turf_decal/trimline/opaque/white/corner{
	dir = 4
	},
/obj/effect/turf_decal/corner/transparent/neutral{
	dir = 8
	},
/obj/effect/turf_decal/corner/transparent/neutral,
/obj/machinery/mecha_part_fabricator/maint,
/turf/open/floor/plasteel/dark,
/area/ruin/unpowered)
"yS" = (
/obj/item/crowbar,
/turf/open/floor/plating{
	icon_state = "platingdmg1"
	},
/area/overmap_encounter/planetoid/sand/explored)
"zF" = (
/turf/template_noop,
/area/template_noop)
"zU" = (
/obj/item/light/bulb/broken{
	pixel_x = 8;
	pixel_y = 8
	},
/obj/item/light/tube/broken{
	pixel_x = -10;
	pixel_y = 6
	},
/obj/effect/decal/cleanable/oil,
/obj/effect/decal/cleanable/dirt,
/obj/effect/decal/cleanable/blood/old,
/turf/open/floor/plasteel,
/area/ruin/unpowered)
"At" = (
/obj/item/spear/bonespear,
/turf/open/floor/plating{
	icon_state = "platingdmg1"
	},
/area/ruin/unpowered)
"BH" = (
/obj/structure/rack,
/obj/item/mop,
/obj/item/reagent_containers/glass/bucket,
/obj/item/storage/bag/trash{
	pixel_x = 6
	},
/turf/open/floor/plating,
/area/ruin/unpowered)
"BJ" = (
/obj/structure/reagent_dispensers/watertank,
/obj/effect/decal/cleanable/oil/slippery,
/turf/open/floor/plating{
	icon_state = "platingdmg1"
	},
/area/ruin/unpowered)
"BT" = (
/obj/structure/window/reinforced,
/obj/structure/shuttle/engine/heater{
	dir = 1
	},
/turf/open/floor/plating,
/area/ruin/unpowered)
"Ce" = (
/obj/item/rack_parts,
/obj/item/storage/bag/ore,
/turf/open/floor/plating,
/area/overmap_encounter/planetoid/sand/explored)
"DA" = (
/obj/effect/turf_decal/corner/transparent/neutral{
	dir = 4
	},
/obj/effect/turf_decal/corner/transparent/neutral,
/obj/effect/turf_decal/trimline/opaque/purple/line{
	dir = 8
	},
/obj/effect/decal/cleanable/dirt,
/turf/open/floor/plasteel/dark,
/area/ruin/unpowered)
"Eh" = (
/obj/item/bedsheet/rd/royal_cape,
/obj/item/toy/figure/rd{
	name = "the Liberator action figure";
	pixel_x = 7;
	pixel_y = -5;
	toysay = "Yeah, go do whatever."
	},
/obj/effect/decal/cleanable/blood/old,
/turf/open/floor/plating,
/area/ruin/unpowered)
"El" = (
/obj/item/shard{
	icon_state = "tiny"
	},
/obj/item/shard{
	icon_state = "small"
	},
/obj/effect/decal/cleanable/dirt,
/turf/open/floor/plating{
	icon_state = "platingdmg1"
	},
/area/ruin/unpowered)
"Fa" = (
/turf/open/floor/plating/asteroid/whitesands,
/area/overmap_encounter/planetoid/sand/explored)
"Fq" = (
/obj/effect/turf_decal/trimline/opaque/purple/line{
	dir = 8
	},
/obj/effect/turf_decal/corner/transparent/neutral,
/obj/effect/turf_decal/corner/transparent/neutral{
	dir = 4
	},
/obj/effect/decal/cleanable/dirt,
/turf/open/floor/plasteel/dark,
/area/ruin/unpowered)
"GC" = (
/obj/item/toy/plush/lizardplushie{
	desc = "Awww! It looks like it will snuggle all of your internal organs!";
	name = "ashwalker plushie"
	},
/obj/effect/mob_spawn/human/corpse{
	mob_species = /datum/species/lizard/ashwalker
	},
/obj/effect/decal/cleanable/dirt,
/obj/effect/decal/cleanable/blood/old,
/turf/open/floor/mineral/titanium/white,
/area/ruin/unpowered)
"GI" = (
/obj/item/storage/bag/ore,
/obj/effect/turf_decal/industrial/outline/yellow,
/obj/effect/turf_decal/trimline/opaque/yellow/line{
	dir = 8
	},
/obj/effect/turf_decal/corner/transparent/neutral{
	dir = 4
	},
/obj/effect/turf_decal/corner/transparent/neutral,
/obj/item/rack_parts,
/obj/item/resonator{
	pixel_x = -6;
	pixel_y = -6
	},
/turf/open/floor/mineral/plastitanium,
/area/overmap_encounter/planetoid/sand/explored)
"GO" = (
/obj/item/shard{
	icon_state = "tiny"
	},
/obj/item/shard,
/obj/item/shard{
	icon_state = "small"
	},
/turf/open/floor/plating,
/area/ruin/unpowered)
"Hl" = (
/obj/effect/decal/cleanable/dirt,
/turf/open/floor/mineral/titanium/white,
/area/ruin/unpowered)
"Ht" = (
/obj/machinery/door/airlock/titanium,
/turf/open/floor/plasteel/dark,
/area/ruin/unpowered)
"HH" = (
/obj/effect/turf_decal/corner/transparent/neutral{
	dir = 1
	},
/obj/effect/turf_decal/corner/transparent/neutral{
	dir = 8
	},
/obj/effect/turf_decal/trimline/opaque/white/line{
	dir = 4
	},
/obj/structure/frame/machine,
/obj/item/stack/cable_coil/cut/random,
/obj/item/surgicaldrill/advanced,
/turf/open/floor/plasteel/dark,
/area/ruin/unpowered)
"Jh" = (
/obj/item/pickaxe,
/obj/effect/decal/cleanable/dirt,
/obj/effect/decal/cleanable/blood/old,
/turf/open/floor/mineral/titanium/white,
/area/ruin/unpowered)
"Jo" = (
/obj/item/shard{
	icon_state = "tiny"
	},
/obj/item/shard{
	icon_state = "small"
	},
/turf/open/floor/plating,
/area/ruin/unpowered)
"Jy" = (
/obj/machinery/light/small/directional/west,
/obj/effect/decal/cleanable/dirt,
/turf/open/floor/plasteel/freezer,
/area/overmap_encounter/planetoid/sand/explored)
"Kw" = (
/obj/effect/turf_decal/corner/transparent/neutral,
/obj/effect/turf_decal/trimline/opaque/purple/line{
	dir = 8
	},
/obj/effect/turf_decal/corner/transparent/neutral{
	dir = 4
	},
/obj/effect/turf_decal/corner/transparent/neutral,
/obj/effect/decal/cleanable/dirt,
/turf/open/floor/plasteel/dark,
/area/ruin/unpowered)
"KJ" = (
/obj/structure/door_assembly/door_assembly_com,
/turf/open/floor/plating{
	icon_state = "panelscorched"
	},
/area/ruin/unpowered)
"Lg" = (
/obj/effect/turf_decal/corner/transparent/neutral,
/obj/effect/turf_decal/trimline/opaque/white/line{
	dir = 9
	},
/obj/structure/table,
/obj/structure/frame/machine,
/obj/item/stack/cable_coil/cut/green,
/obj/item/circuitboard/machine/reagentgrinder,
/turf/open/floor/plasteel/dark,
/area/ruin/unpowered)
"Li" = (
/obj/machinery/cell_charger,
/obj/effect/decal/cleanable/dirt,
/turf/open/floor/mineral/titanium/purple,
/area/ruin/unpowered)
"Lk" = (
/obj/item/light/bulb/broken{
	pixel_x = -13;
	pixel_y = -12
	},
/obj/item/light/tube/broken{
	pixel_x = -10;
	pixel_y = -6
	},
/obj/item/shard{
	icon_state = "small"
	},
/obj/effect/decal/cleanable/oil,
/obj/effect/decal/cleanable/dirt,
/obj/effect/decal/cleanable/blood/old,
/turf/open/floor/plasteel,
/area/ruin/unpowered)
"LD" = (
/turf/open/floor/plating/asteroid/whitesands,
/area/ruin/unpowered)
"LI" = (
/obj/effect/turf_decal/corner/transparent/neutral{
	dir = 8
	},
/obj/effect/turf_decal/corner/transparent/neutral{
	dir = 1
	},
/obj/effect/turf_decal/trimline/opaque/purple/line{
	dir = 4
	},
/obj/effect/decal/cleanable/dirt,
/turf/open/floor/plasteel/dark,
/area/ruin/unpowered)
"Nq" = (
/obj/item/shard,
/obj/effect/decal/cleanable/dirt,
/turf/open/floor/plating{
	icon_state = "platingdmg1"
	},
/area/ruin/unpowered)
"Nt" = (
/obj/effect/turf_decal/industrial/outline/yellow,
/obj/effect/turf_decal/corner/transparent/neutral,
/obj/effect/turf_decal/trimline/opaque/yellow/line{
	dir = 8
	},
/obj/effect/turf_decal/corner/transparent/neutral{
	dir = 4
	},
/turf/open/floor/mineral/plastitanium,
/area/overmap_encounter/planetoid/sand/explored)
"Op" = (
/obj/item/storage/box/rndboards,
/obj/effect/decal/cleanable/dirt,
/obj/effect/decal/cleanable/blood/old,
/turf/open/floor/mineral/titanium/white,
/area/ruin/unpowered)
"Os" = (
/obj/structure/door_assembly/door_assembly_min{
	dir = 4
	},
/turf/open/floor/plating,
/area/ruin/unpowered)
"Ou" = (
/obj/effect/turf_decal/corner/transparent/neutral{
	dir = 4
	},
/obj/effect/turf_decal/corner/transparent/neutral,
/obj/effect/turf_decal/trimline/opaque/white/line{
	dir = 8
	},
/obj/machinery/autolathe,
/obj/effect/decal/cleanable/dirt,
/turf/open/floor/plasteel/dark,
/area/ruin/unpowered)
"Pv" = (
/obj/structure/ore_box,
/turf/open/floor/mineral/plastitanium,
/area/overmap_encounter/planetoid/sand/explored)
"QZ" = (
/turf/open/floor/plating{
	icon_state = "panelscorched"
	},
/area/ruin/unpowered)
"Ra" = (
/obj/structure/table,
/obj/effect/decal/cleanable/blood/old,
/turf/open/floor/plating,
/area/ruin/unpowered)
"Rn" = (
/obj/effect/decal/cleanable/dirt,
/obj/effect/decal/cleanable/blood/old,
/turf/open/floor/mineral/titanium/purple,
/area/ruin/unpowered)
"RN" = (
/obj/item/shard{
	icon_state = "small"
	},
/obj/effect/decal/cleanable/dirt,
/turf/open/floor/plating{
	icon_state = "platingdmg1"
	},
/area/ruin/unpowered)
"Si" = (
/obj/structure/girder,
/turf/open/floor/plating{
	icon_state = "platingdmg1"
	},
/area/ruin/unpowered)
"Sk" = (
/obj/item/card/id/mining,
/turf/open/floor/plating{
	icon_state = "platingdmg1"
	},
/area/overmap_encounter/planetoid/sand/explored)
"SW" = (
/obj/machinery/door/airlock/external,
/turf/open/floor/plasteel/dark,
/area/ruin/unpowered)
"TH" = (
/obj/machinery/door/airlock/titanium,
/obj/effect/turf_decal/industrial/warning,
/obj/effect/turf_decal/industrial/warning{
	dir = 1
	},
/turf/open/floor/plasteel/dark,
/area/ruin/unpowered)
"Ua" = (
/obj/item/light/bulb/broken{
	pixel_x = -3;
	pixel_y = -9
	},
/obj/item/shard{
	icon_state = "medium"
	},
/obj/effect/decal/cleanable/oil,
/obj/effect/decal/cleanable/dirt,
/turf/open/floor/plasteel,
/area/ruin/unpowered)
"UC" = (
/obj/item/spear,
/obj/effect/mob_spawn/human/corpse{
	mob_species = /datum/species/lizard/ashwalker
	},
/obj/effect/decal/cleanable/dirt,
/obj/effect/decal/cleanable/blood/old,
/turf/open/floor/plating{
	icon_state = "platingdmg1"
	},
/area/ruin/unpowered)
"UV" = (
/obj/structure/table,
/turf/open/floor/plating{
	icon_state = "panelscorched"
	},
/area/ruin/unpowered)
"Ve" = (
/obj/item/shard{
	icon_state = "tiny"
	},
/obj/item/shard{
	icon_state = "medium"
	},
/obj/effect/decal/cleanable/dirt,
/turf/open/floor/plating{
	icon_state = "platingdmg1"
	},
/area/ruin/unpowered)
"Vo" = (
/turf/open/floor/plating,
/area/ruin/unpowered)
"Vp" = (
/turf/open/floor/plating{
	icon_state = "panelscorched"
	},
/area/overmap_encounter/planetoid/sand/explored)
"Vq" = (
/obj/item/storage/box,
/obj/item/light/bulb/broken,
/obj/item/light/tube/broken,
/obj/effect/decal/cleanable/dirt,
/turf/open/floor/plasteel,
/area/ruin/unpowered)
"Wr" = (
/obj/effect/turf_decal/corner/transparent/neutral,
/obj/effect/turf_decal/corner/transparent/neutral{
	dir = 8
	},
/obj/effect/turf_decal/trimline/opaque/white/corner{
	dir = 1
	},
/obj/structure/table,
/obj/item/areaeditor/blueprints{
	desc = "Use to build new structures in the wastes.";
	name = "land claim"
	},
/obj/effect/decal/cleanable/blood/old,
/turf/open/floor/plasteel/dark,
/area/ruin/unpowered)
"Xa" = (
/obj/item/light/bulb/broken{
	pixel_x = 7;
	pixel_y = 7
	},
/obj/item/light/tube/broken{
	pixel_x = 12;
	pixel_y = -7
	},
/obj/effect/decal/cleanable/oil/streak,
/obj/effect/decal/cleanable/dirt,
/turf/open/floor/plasteel,
/area/ruin/unpowered)
"Xo" = (
/obj/item/pickaxe{
	pixel_x = -6;
	pixel_y = 17
	},
/obj/item/mining_scanner,
/turf/open/floor/plating{
	icon_state = "panelscorched"
	},
/area/overmap_encounter/planetoid/sand/explored)
"Xr" = (
/obj/effect/decal/cleanable/blood/old,
/turf/open/floor/plating{
	icon_state = "platingdmg1"
	},
/area/ruin/unpowered)
"Yx" = (
/obj/effect/decal/cleanable/dirt,
/obj/effect/decal/cleanable/blood/old,
/turf/open/floor/plasteel/dark,
/area/ruin/unpowered)
"YO" = (
/obj/effect/turf_decal/corner/transparent/neutral{
	dir = 8
	},
/obj/effect/turf_decal/corner/transparent/neutral{
	dir = 1
	},
/turf/open/floor/plating/asteroid/whitesands,
/area/ruin/unpowered)
"YS" = (
/turf/open/floor/plating{
	icon_state = "platingdmg1"
	},
/area/ruin/unpowered)
"YT" = (
/obj/item/shard{
	icon_state = "tiny"
	},
/turf/open/floor/plating,
/area/ruin/unpowered)
"YX" = (
/obj/structure/rack,
/obj/item/pickaxe,
/turf/open/floor/mineral/plastitanium,
/area/overmap_encounter/planetoid/sand/explored)
"Zb" = (
/obj/machinery/mineral/ore_redemption{
	input_dir = 4;
	output_dir = 8
	},
/turf/open/floor/plating,
/area/ruin/unpowered)
"Zc" = (
/obj/effect/turf_decal/corner/transparent/neutral,
/obj/effect/turf_decal/corner/transparent/neutral{
	dir = 4
	},
/obj/effect/turf_decal/trimline/opaque/white/line{
	dir = 8
	},
/obj/structure/table,
/obj/item/storage/firstaid/brute,
/turf/open/floor/plasteel/dark,
/area/ruin/unpowered)
"Zj" = (
/obj/structure/frame/machine,
/turf/open/floor/plasteel/dark,
/area/ruin/unpowered)
"Zk" = (
/obj/effect/turf_decal/corner/transparent/neutral{
	dir = 1
	},
/obj/effect/turf_decal/corner/transparent/neutral{
	dir = 8
	},
/obj/effect/turf_decal/trimline/opaque/purple/line{
	dir = 4
	},
/turf/open/floor/plasteel/dark,
/area/ruin/unpowered)

(1,1,1) = {"
zF
zF
zF
tC
tC
cD
cD
Si
cD
bX
Fa
zF
zF
zF
zF
zF
zF
zF
zF
zF
zF
zF
zF
"}
(2,1,1) = {"
dm
dm
cD
tC
qa
BH
ib
bX
Jy
cF
Fa
Fa
zF
zF
zF
zF
zF
zF
zF
zF
zF
zF
zF
"}
(3,1,1) = {"
sJ
BT
cD
kw
xe
xe
LD
cD
ba
Vp
cF
je
Fa
zF
zF
zF
zF
zF
zF
zF
zF
zF
zF
"}
(4,1,1) = {"
sJ
BT
cD
Ra
UC
LD
LD
qE
jN
Fa
Vp
Fa
Fa
Fa
zF
zF
zF
zF
zF
zF
zF
zF
zF
"}
(5,1,1) = {"
dm
dm
ur
Si
Ht
ur
jf
Si
cF
Vp
bD
qZ
fh
Fa
zF
zF
zF
zF
zF
zF
zF
zF
zF
"}
(6,1,1) = {"
sJ
BT
YS
Vo
LD
cD
cD
cD
cD
cD
cD
cD
cD
YT
YT
cD
qE
qE
cD
cD
Fa
zF
zF
"}
(7,1,1) = {"
sJ
BT
Si
LD
vg
QZ
ur
Lg
Zc
UV
Ou
YS
nl
Kw
Fq
YS
xe
DA
cn
id
Fa
Fa
zF
"}
(8,1,1) = {"
cD
cD
cD
sM
ah
Yx
cD
Wr
jk
Hl
Hl
YS
YS
pj
pj
Eh
cn
Nq
cn
KJ
yS
Vp
Fa
"}
(9,1,1) = {"
SW
sY
SW
gt
Xa
vb
TH
Xr
th
YS
mX
Jh
eh
Li
uz
pj
RN
El
El
id
rA
Fa
rA
"}
(10,1,1) = {"
SW
sY
SW
qD
Vq
zU
TH
Hl
Hl
GC
Vo
Op
YS
pj
Zj
Rn
vq
dd
Ve
bX
Fa
cF
cF
"}
(11,1,1) = {"
cD
cD
cD
kU
Lk
au
cD
yg
Hl
At
Hl
iJ
hI
vo
YS
cn
cn
cn
cn
qw
cF
Vp
Fa
"}
(12,1,1) = {"
sJ
iX
cD
BJ
Ua
nD
cD
hY
YS
bL
HH
YS
Zk
LI
YO
cn
LI
cn
YS
cF
Fa
Fa
Fa
"}
(13,1,1) = {"
sJ
iX
cD
xK
pD
cD
cD
cD
cD
Os
cD
Zb
GO
cD
cD
cD
Os
Jo
id
Fa
zF
zF
zF
"}
(14,1,1) = {"
dm
dm
cD
cD
lc
cD
iY
GI
Sk
Nt
Fa
Fa
Fa
zF
zF
zF
zF
zF
zF
zF
zF
zF
zF
"}
(15,1,1) = {"
sJ
BT
cD
Pv
pR
cF
gz
Fa
Fa
Fa
zF
zF
zF
zF
zF
zF
zF
zF
zF
zF
zF
zF
zF
"}
(16,1,1) = {"
sJ
BT
cD
gg
iO
Xo
cF
Sk
Fa
zF
zF
zF
zF
zF
zF
zF
zF
zF
zF
zF
zF
zF
zF
"}
(17,1,1) = {"
dm
dm
cD
cD
YX
Ce
sw
ai
ni
zF
zF
zF
zF
zF
zF
zF
zF
zF
zF
zF
zF
zF
zF
"}
(18,1,1) = {"
zF
zF
zF
cD
cD
Fa
Fa
zF
zF
zF
zF
zF
zF
zF
zF
zF
zF
zF
zF
zF
zF
zF
zF
"}
