//MAP CONVERTED BY dmm2tgm.py THIS HEADER COMMENT PREVENTS RECONVERSION, DO NOT REMOVE
"aa" = (
/turf/template_noop,
/area/template_noop)
"ab" = (
/turf/open/floor/plating{
	icon_state = "panelscorched";
	initial_gas_mix = "ws_atmos"
	},
/area/whitesands/surface/outdoors)
"ac" = (
/obj/effect/spawner/structure/window/plasma/reinforced,
/turf/open/floor/plating{
	initial_gas_mix = "ws_atmos"
	},
/area/whitesands/surface/outdoors)
"ad" = (
/obj/machinery/atmospherics/components/unary/vent_scrubber/on,
/turf/open/floor/engine,
/area/ruin/unpowered)
"ae" = (
/obj/structure/girder,
/turf/open/floor/plating{
	initial_gas_mix = "ws_atmos"
	},
/area/ruin/unpowered)
"af" = (
/turf/open/floor/plating/asteroid/whitesands,
/area/whitesands/surface/outdoors)
"ag" = (
/obj/effect/turf_decal/industrial/outline/yellow{
	dir = 1
	},
/turf/open/floor/plasteel/dark,
/area/whitesands/surface/outdoors)
"ah" = (
/obj/machinery/door/airlock/engineering/glass/critical{
	heat_proof = 1;
	name = "Supermatter Chamber";
	req_access_txt = "10";
	dir = 4
	},
/turf/open/floor/engine,
/area/ruin/unpowered)
"ai" = (
/obj/effect/decal/cleanable/greenglow,
/obj/item/disk/plantgene,
/turf/open/floor/plating{
	icon_state = "platingdmg2";
	initial_gas_mix = "ws_atmos"
	},
/area/whitesands/surface/outdoors)
"aj" = (
/obj/machinery/atmospherics/pipe/simple/general/visible{
	dir = 10
	},
/turf/closed/wall/r_wall,
/area/whitesands/surface/outdoors)
"ak" = (
/obj/structure/window/plasma/reinforced,
/obj/machinery/power/rad_collector/anchored,
/obj/machinery/atmospherics/pipe/simple/general/visible{
	dir = 10
	},
/turf/open/floor/plating/asteroid/whitesands,
/area/whitesands/surface/outdoors)
"al" = (
/obj/structure/window/plasma/reinforced{
	dir = 1
	},
/obj/machinery/power/rad_collector/anchored,
/obj/machinery/atmospherics/pipe/manifold/general/visible,
/turf/open/floor/plating{
	icon_state = "platingdmg1";
	initial_gas_mix = "ws_atmos"
	},
/area/ruin/unpowered)
"am" = (
/obj/effect/decal/cleanable/dirt,
/turf/open/floor/plating{
	icon_state = "panelscorched";
	initial_gas_mix = "ws_atmos"
	},
/area/ruin/unpowered)
"an" = (
/obj/effect/decal/cleanable/dirt,
/turf/open/floor/plating{
	icon_state = "panelscorched";
	initial_gas_mix = "ws_atmos"
	},
/area/whitesands/surface/outdoors)
"ao" = (
/obj/structure/girder/displaced,
/turf/open/floor/plating{
	initial_gas_mix = "ws_atmos"
	},
/area/ruin/unpowered)
"ap" = (
/turf/open/floor/plating/asteroid/whitesands,
/area/ruin/unpowered)
"aq" = (
/obj/effect/mob_spawn/human/engineer{
	gender = "female";
	mob_species = null
	},
/obj/item/clothing/suit/radiation,
/obj/item/clothing/head/radiation{
	pixel_x = -1;
	pixel_y = 9
	},
/obj/item/geiger_counter,
/turf/open/floor/engine,
/area/ruin/unpowered)
"ar" = (
/obj/machinery/atmospherics/components/unary/vent_scrubber/on,
/obj/effect/decal/cleanable/dirt,
/turf/open/floor/engine,
/area/whitesands/surface/outdoors)
"as" = (
/obj/effect/turf_decal/industrial/outline/yellow{
	dir = 1
	},
/obj/machinery/portable_atmospherics/canister/nitrogen,
/turf/open/floor/plasteel/dark,
/area/whitesands/surface/outdoors)
"at" = (
/obj/machinery/atmospherics/components/unary/vent_scrubber/on,
/turf/open/floor/engine,
/area/whitesands/surface/outdoors)
"au" = (
/obj/machinery/atmospherics/pipe/simple/general/visible{
	dir = 9
	},
/turf/closed/wall/r_wall,
/area/whitesands/surface/outdoors)
"av" = (
/obj/machinery/door/airlock/engineering/glass/critical{
	heat_proof = 1;
	name = "Supermatter Chamber";
	req_access_txt = "10";
	dir = 4
	},
/turf/open/floor/plating{
	icon_state = "platingdmg2";
	initial_gas_mix = "ws_atmos"
	},
/area/ruin/unpowered)
"aw" = (
/turf/closed/wall/r_wall,
/area/whitesands/surface/outdoors)
"ax" = (
/obj/effect/mob_spawn/human/engineer{
	gender = "female";
	mob_species = null
	},
/obj/item/clothing/suit/radiation,
/obj/item/clothing/head/radiation{
	pixel_x = -1;
	pixel_y = 9
	},
/obj/item/geiger_counter,
/turf/open/floor/engine,
/area/whitesands/surface/outdoors)
"ay" = (
/turf/open/floor/plating{
	icon_state = "panelscorched";
	initial_gas_mix = "ws_atmos"
	},
/area/ruin/unpowered)
"az" = (
/obj/effect/decal/cleanable/dirt,
/turf/open/floor/plating{
	initial_gas_mix = "ws_atmos"
	},
/area/whitesands/surface/outdoors)
"aA" = (
/obj/effect/turf_decal/industrial/outline/yellow{
	dir = 1
	},
/turf/open/floor/plasteel/dark,
/area/ruin/unpowered)
"aB" = (
/obj/effect/turf_decal/industrial/hatch/yellow,
/obj/effect/decal/cleanable/dirt,
/turf/open/floor/plasteel/dark,
/area/whitesands/surface/outdoors)
"aC" = (
/obj/effect/decal/cleanable/dirt,
/turf/open/floor/engine,
/area/whitesands/surface/outdoors)
"aD" = (
/obj/effect/turf_decal/industrial/hatch/yellow,
/obj/effect/decal/cleanable/dirt,
/turf/open/floor/plasteel/dark,
/area/ruin/unpowered)
"aE" = (
/obj/effect/decal/cleanable/greenglow,
/obj/effect/decal/cleanable/dirt,
/turf/open/floor/plating{
	initial_gas_mix = "ws_atmos"
	},
/area/whitesands/surface/outdoors)
"aF" = (
/obj/effect/decal/cleanable/dirt,
/turf/open/floor/engine,
/area/ruin/unpowered)
"aG" = (
/obj/machinery/atmospherics/components/binary/pump{
	dir = 8
	},
/turf/open/floor/plating{
	icon_state = "platingdmg2";
	initial_gas_mix = "ws_atmos"
	},
/area/whitesands/surface/outdoors)
"aH" = (
/obj/structure/girder/displaced,
/turf/open/floor/plating{
	initial_gas_mix = "ws_atmos"
	},
/area/whitesands/surface/outdoors)
"aI" = (
/obj/machinery/atmospherics/components/unary/vent_pump/on{
	dir = 1
	},
/obj/effect/decal/cleanable/dirt,
/turf/open/floor/engine,
/area/whitesands/surface/outdoors)
"aJ" = (
/obj/structure/window/plasma/reinforced{
	dir = 1
	},
/obj/structure/frame/machine,
/obj/machinery/atmospherics/pipe/simple/general/visible{
	dir = 9
	},
/obj/machinery/atmospherics/pipe/simple/general/visible{
	dir = 9
	},
/turf/open/floor/plating{
	icon_state = "platingdmg2";
	initial_gas_mix = "ws_atmos"
	},
/area/whitesands/surface/outdoors)
"aK" = (
/obj/machinery/atmospherics/components/unary/vent_scrubber/on,
/obj/effect/decal/cleanable/dirt,
/turf/open/floor/engine,
/area/ruin/unpowered)
"aL" = (
/obj/structure/window/plasma/reinforced{
	dir = 1
	},
/obj/machinery/power/rad_collector/anchored,
/obj/machinery/atmospherics/pipe/manifold/general/visible,
/turf/open/floor/plating{
	icon_state = "platingdmg1";
	initial_gas_mix = "ws_atmos"
	},
/area/whitesands/surface/outdoors)
"aM" = (
/obj/machinery/atmospherics/components/binary/pump{
	dir = 8
	},
/turf/open/floor/plating{
	icon_state = "platingdmg2";
	initial_gas_mix = "ws_atmos"
	},
/area/ruin/unpowered)
"aN" = (
/turf/closed/wall/r_wall,
/area/ruin/unpowered)
"aO" = (
/obj/structure/window/plasma/reinforced{
	dir = 1
	},
/obj/structure/frame/machine,
/obj/machinery/atmospherics/pipe/simple/general/visible{
	dir = 9
	},
/obj/machinery/atmospherics/pipe/simple/general/visible{
	dir = 9
	},
/turf/open/floor/plating{
	icon_state = "platingdmg2";
	initial_gas_mix = "ws_atmos"
	},
/area/ruin/unpowered)
"aP" = (
/obj/structure/window/plasma/reinforced{
	dir = 1
	},
/obj/structure/frame/machine,
/obj/machinery/atmospherics/pipe/manifold/general/visible,
/turf/open/floor/engine,
/area/ruin/unpowered)
"aQ" = (
/obj/machinery/atmospherics/pipe/simple/general/visible{
	dir = 6
	},
/obj/structure/girder,
/turf/open/floor/plating{
	initial_gas_mix = "ws_atmos"
	},
/area/whitesands/surface/outdoors)
"aR" = (
/obj/structure/window/plasma/reinforced,
/obj/machinery/power/rad_collector/anchored,
/obj/machinery/atmospherics/pipe/manifold/general/visible{
	dir = 1
	},
/turf/open/floor/plating{
	icon_state = "platingdmg2";
	initial_gas_mix = "ws_atmos"
	},
/area/whitesands/surface/outdoors)
"aS" = (
/turf/open/floor/plating{
	initial_gas_mix = "ws_atmos"
	},
/area/whitesands/surface/outdoors)
"aT" = (
/obj/structure/window/plasma/reinforced{
	dir = 1
	},
/obj/structure/frame/machine,
/obj/machinery/atmospherics/pipe/manifold/general/visible,
/turf/open/floor/engine,
/area/whitesands/surface/outdoors)
"aU" = (
/obj/machinery/atmospherics/pipe/simple/general/visible{
	dir = 10
	},
/turf/closed/wall/r_wall,
/area/ruin/unpowered)
"aV" = (
/turf/open/floor/plating{
	icon_state = "platingdmg1";
	initial_gas_mix = "ws_atmos"
	},
/area/whitesands/surface/outdoors)
"aW" = (
/obj/machinery/door/airlock/engineering/glass/critical{
	heat_proof = 1;
	name = "Supermatter Chamber";
	req_access_txt = "10"
	},
/turf/open/floor/plating{
	icon_state = "platingdmg2";
	initial_gas_mix = "ws_atmos"
	},
/area/whitesands/surface/outdoors)
"aX" = (
/obj/structure/girder,
/turf/open/floor/plating{
	initial_gas_mix = "ws_atmos"
	},
/area/whitesands/surface/outdoors)
"aY" = (
/obj/machinery/door/airlock/engineering/glass/critical{
	heat_proof = 1;
	name = "Supermatter Chamber";
	req_access_txt = "10"
	},
/turf/open/floor/engine,
/area/whitesands/surface/outdoors)
"aZ" = (
/obj/structure/window/plasma/reinforced,
/obj/structure/frame/machine,
/obj/machinery/atmospherics/pipe/manifold/general/visible{
	dir = 1
	},
/turf/open/floor/plating{
	icon_state = "platingdmg1";
	initial_gas_mix = "ws_atmos"
	},
/area/whitesands/surface/outdoors)
"dE" = (
/obj/machinery/atmospherics/pipe/simple/general/visible{
	dir = 6
	},
/obj/structure/girder,
/turf/open/floor/plating{
	initial_gas_mix = "ws_atmos"
	},
/area/ruin/unpowered)
"jt" = (
/obj/structure/window/plasma/reinforced,
/obj/machinery/power/rad_collector/anchored,
/obj/machinery/atmospherics/pipe/simple/general/visible{
	dir = 10
	},
/turf/open/floor/plating/asteroid/whitesands,
/area/ruin/unpowered)
"lF" = (
/obj/structure/window/plasma/reinforced,
/obj/machinery/power/rad_collector/anchored,
/obj/machinery/atmospherics/pipe/manifold/general/visible{
	dir = 1
	},
/turf/open/floor/plating{
	icon_state = "platingdmg2";
	initial_gas_mix = "ws_atmos"
	},
/area/ruin/unpowered)
"qx" = (
/turf/open/floor/plating{
	icon_state = "platingdmg1";
	initial_gas_mix = "ws_atmos"
	},
/area/ruin/unpowered)
"zm" = (
/obj/effect/decal/cleanable/dirt,
/turf/open/floor/plating{
	initial_gas_mix = "ws_atmos"
	},
/area/ruin/unpowered)
"BI" = (
/obj/structure/window/plasma/reinforced,
/obj/structure/frame/machine,
/obj/machinery/atmospherics/pipe/manifold/general/visible{
	dir = 1
	},
/turf/open/floor/plating{
	icon_state = "platingdmg1";
	initial_gas_mix = "ws_atmos"
	},
/area/ruin/unpowered)
"HM" = (
/obj/effect/turf_decal/industrial/outline/yellow{
	dir = 1
	},
/obj/machinery/portable_atmospherics/canister/nitrogen,
/turf/open/floor/plasteel/dark,
/area/ruin/unpowered)
"LT" = (
/obj/machinery/atmospherics/components/unary/vent_pump/on{
	dir = 1
	},
/obj/effect/decal/cleanable/dirt,
/turf/open/floor/engine,
/area/ruin/unpowered)
"Ma" = (
/obj/machinery/atmospherics/pipe/simple/general/visible{
	dir = 9
	},
/turf/closed/wall/r_wall,
/area/ruin/unpowered)
"OH" = (
/obj/effect/decal/cleanable/greenglow,
/obj/effect/decal/cleanable/dirt,
/turf/open/floor/plating{
	initial_gas_mix = "ws_atmos"
	},
/area/ruin/unpowered)
"Pq" = (
/turf/open/floor/plating{
	initial_gas_mix = "ws_atmos"
	},
/area/ruin/unpowered)
"Rm" = (
/obj/effect/spawner/structure/window/plasma/reinforced,
/turf/open/floor/plating{
	initial_gas_mix = "ws_atmos"
	},
/area/ruin/unpowered)
"VN" = (
/obj/effect/decal/cleanable/greenglow,
/obj/item/disk/plantgene,
/turf/open/floor/plating{
	icon_state = "platingdmg2";
	initial_gas_mix = "ws_atmos"
	},
/area/ruin/unpowered)

(1,1,1) = {"
aa
zm
ae
aN
av
aN
ao
aD
aa
"}
(2,1,1) = {"
HM
zm
aN
zm
aq
aM
aN
aA
aa
"}
(3,1,1) = {"
aN
ae
dE
Ma
ah
aU
aN
aN
aN
"}
(4,1,1) = {"
aa
qx
lF
LT
VN
aK
al
ap
aa
"}
(5,1,1) = {"
aa
zm
BI
LT
OH
aK
aP
am
ay
"}
(6,1,1) = {"
Pq
Pq
jt
LT
aF
ad
aO
aF
aa
"}
(7,1,1) = {"
ae
aN
aN
aN
Rm
aN
aN
ae
aN
"}
