//MAP CONVERTED BY dmm2tgm.py THIS HEADER COMMENT PREVENTS RECONVERSION, DO NOT REMOVE
"aa" = (
/obj/structure/barricade/sandbags,
/turf/open/floor/plating/asteroid/whitesands/dried/lit,
/area/overmap_encounter/planetoid/sand/explored)
"ab" = (
/obj/item/ammo_casing/spent,
/turf/closed/wall/mineral/plastitanium,
/area/ruin)
"ac" = (
/obj/structure/chair/comfy/shuttle{
	dir = 4
	},
/obj/effect/decal/cleanable/dirt/dust,
/turf/open/floor/mineral/plastitanium/red,
/area/whitesands/surface/outdoors)
"ad" = (
/obj/item/ammo_casing/spent,
/turf/closed/wall/mineral/plastitanium,
/area/whitesands/surface/outdoors)
"ae" = (
/obj/structure/barricade/wooden,
/obj/machinery/door/airlock/centcom{
	aiControlDisabled = 1;
	name = "Assault Pod";
	req_access_txt = "150"
	},
/turf/open/floor/plating,
/area/whitesands/surface/outdoors)
"af" = (
/mob/living/simple_animal/hostile/asteroid/goliath/beast,
/turf/open/floor/mineral/plastitanium/red,
/area/whitesands/surface/outdoors)
"ag" = (
/obj/effect/decal/cleanable/blood/gibs,
/turf/open/floor/plating/asteroid/whitesands/dried/lit,
/area/overmap_encounter/planetoid/sand/explored)
"ah" = (
/turf/closed/wall/mineral/plastitanium,
/area/whitesands/surface/outdoors)
"ai" = (
/obj/item/ammo_casing/c10mm{
	pixel_x = -1
	},
/obj/item/ammo_casing/c10mm{
	pixel_x = 7;
	pixel_y = -7
	},
/obj/item/ammo_casing/c10mm{
	pixel_x = -2;
	pixel_y = -10
	},
/obj/item/ammo_casing/c10mm{
	pixel_x = -6;
	pixel_y = -5
	},
/obj/item/ammo_casing/c10mm{
	pixel_x = -6;
	pixel_y = 4
	},
/turf/open/floor/plating/asteroid/whitesands/dried/lit,
/area/whitesands/surface/outdoors)
"aj" = (
/obj/effect/decal/cleanable/blood/gibs,
/turf/open/floor/plating/asteroid/whitesands/dried/lit,
/area/whitesands/surface/outdoors)
"ak" = (
/obj/structure/chair/comfy/shuttle{
	dir = 4
	},
/turf/closed/mineral/random/whitesands,
/area/whitesands/surface/outdoors)
"al" = (
/obj/effect/decal/cleanable/blood/splatter,
/turf/open/floor/mineral/plastitanium/red,
/area/whitesands/surface/outdoors)
"am" = (
/mob/living/simple_animal/hostile/asteroid/goliath/beast{
	dir = 4
	},
/turf/open/floor/plating/asteroid/whitesands/dried/lit,
/area/overmap_encounter/planetoid/sand/explored)
"an" = (
/obj/machinery/light/broken/directional/north,
/obj/effect/decal/cleanable/dirt/dust,
/turf/open/floor/mineral/plastitanium/red,
/area/ruin)
"ao" = (
/obj/item/ammo_casing/spent,
/obj/item/ammo_casing/spent{
	dir = 5;
	pixel_x = -8;
	pixel_y = 4
	},
/obj/item/ammo_casing/spent{
	dir = 1;
	pixel_x = 7;
	pixel_y = 4
	},
/turf/open/floor/plating/asteroid/whitesands/lit,
/area/whitesands/surface/outdoors)
"ap" = (
/obj/effect/decal/cleanable/dirt/dust,
/turf/open/floor/mineral/plastitanium/red,
/area/whitesands/surface/outdoors)
"aq" = (
/obj/structure/chair/comfy/shuttle{
	dir = 4
	},
/turf/open/floor/mineral/plastitanium/red,
/area/whitesands/surface/outdoors)
"ar" = (
/obj/effect/decal/cleanable/blood/gibs/core,
/obj/effect/decal/cleanable/dirt/dust,
/turf/open/floor/mineral/plastitanium/red,
/area/whitesands/surface/outdoors)
"as" = (
/obj/structure/closet/crate/secure/weapon,
/obj/item/gun/ballistic/automatic/ebr,
/obj/item/ammo_box/magazine/ebr,
/obj/effect/decal/cleanable/dirt/dust,
/turf/open/floor/mineral/plastitanium/red,
/area/ruin)
"at" = (
/obj/machinery/door/airlock/centcom{
	aiControlDisabled = 1;
	name = "Assault Pod";
	req_access_txt = "150"
	},
/obj/item/ammo_casing/spent,
/turf/closed/mineral/random/whitesands,
/area/whitesands/surface/outdoors)
"au" = (
/obj/item/reagent_containers/food/drinks/waterbottle/large{
	pixel_x = -8;
	pixel_y = 2
	},
/obj/item/reagent_containers/food/snacks/canned/beans{
	pixel_x = 6;
	pixel_y = 1
	},
/turf/open/floor/mineral/plastitanium/red,
/area/whitesands/surface/outdoors)
"av" = (
/obj/item/ammo_casing/spent,
/turf/closed/mineral/random/whitesands,
/area/whitesands/surface/outdoors)
"aw" = (
/turf/open/floor/mineral/plastitanium/red,
/area/whitesands/surface/outdoors)
"ax" = (
/obj/effect/decal/cleanable/blood/splatter,
/turf/open/floor/mineral/plastitanium/red,
/area/ruin)
"ay" = (
/obj/structure/bed,
/obj/effect/decal/cleanable/blood{
	icon_state = "floor2"
	},
/turf/open/floor/mineral/plastitanium/red,
/area/ruin)
"az" = (
/obj/structure/barricade/sandbags,
/turf/open/floor/plating/asteroid/whitesands/lit,
/area/whitesands/surface/outdoors)
"aA" = (
/obj/effect/decal/cleanable/blood{
	icon_state = "floor7"
	},
/turf/open/floor/plating/asteroid/whitesands/dried/lit,
/area/whitesands/surface/outdoors)
"aB" = (
/turf/open/floor/plating/asteroid/whitesands/lit,
/area/whitesands/surface/outdoors)
"aC" = (
/turf/open/floor/plating/asteroid/whitesands/lit,
/area/overmap_encounter/planetoid/sand/explored)
"aD" = (
/obj/machinery/light/broken/directional/north,
/obj/effect/decal/cleanable/dirt/dust,
/turf/open/floor/mineral/plastitanium/red,
/area/whitesands/surface/outdoors)
"aE" = (
/turf/open/floor/plating/asteroid/whitesands/dried/lit,
/area/whitesands/surface/outdoors)
"aF" = (
/obj/effect/decal/cleanable/blood/gibs/up,
/obj/effect/decal/cleanable/blood,
/obj/item/clothing/under/syndicate/intern{
	pixel_x = 1;
	pixel_y = -6
	},
/turf/open/floor/mineral/plastitanium/red,
/area/whitesands/surface/outdoors)
"aG" = (
/turf/open/floor/mineral/plastitanium/red,
/area/ruin)
"aH" = (
/obj/structure/chair/comfy/shuttle{
	dir = 8
	},
/obj/effect/decal/cleanable/dirt/dust,
/turf/open/floor/mineral/plastitanium/red,
/area/whitesands/surface/outdoors)
"aI" = (
/turf/closed/wall/mineral/plastitanium,
/area/ruin)
"aJ" = (
/obj/structure/bed,
/obj/effect/decal/cleanable/blood{
	icon_state = "floor2"
	},
/turf/open/floor/mineral/plastitanium/red,
/area/whitesands/surface/outdoors)
"aK" = (
/mob/living/simple_animal/hostile/asteroid/goliath/beast{
	dir = 4
	},
/turf/open/floor/plating/asteroid/whitesands/dried/lit,
/area/whitesands/surface/outdoors)
"aL" = (
/obj/machinery/light/directional/south,
/turf/open/floor/mineral/plastitanium/red,
/area/whitesands/surface/outdoors)
"aM" = (
/obj/effect/decal/cleanable/blood/gibs/core,
/obj/effect/decal/cleanable/dirt/dust,
/turf/open/floor/mineral/plastitanium/red,
/area/ruin)
"aN" = (
/obj/structure/barricade/wooden,
/obj/machinery/door/airlock/centcom{
	aiControlDisabled = 1;
	name = "Assault Pod";
	req_access_txt = "150"
	},
/turf/open/floor/plating,
/area/ruin)
"aO" = (
/turf/template_noop,
/area/template_noop)
"aP" = (
/obj/structure/closet/crate/secure/weapon,
/obj/item/gun/ballistic/automatic/ebr,
/obj/item/ammo_box/magazine/ebr,
/obj/effect/decal/cleanable/dirt/dust,
/turf/open/floor/mineral/plastitanium/red,
/area/whitesands/surface/outdoors)
"aQ" = (
/obj/effect/decal/cleanable/dirt/dust,
/turf/open/floor/mineral/plastitanium/red,
/area/ruin)
"aR" = (
/obj/machinery/door/airlock/centcom{
	name = "Assault Pod";
	req_access_txt = "150"
	},
/turf/open/floor/plating,
/area/whitesands/surface/outdoors)
"aS" = (
/obj/effect/decal/cleanable/blood,
/obj/effect/mob_spawn/human/corpse/syndicatesoldier,
/turf/open/floor/plating/asteroid/whitesands/lit,
/area/whitesands/surface/outdoors)
"aT" = (
/obj/effect/decal/cleanable/blood/gibs/limb{
	icon_state = "gibarm";
	pixel_x = -14;
	pixel_y = 3
	},
/obj/effect/decal/cleanable/blood{
	icon_state = "floor5";
	pixel_x = -2
	},
/turf/open/floor/plating,
/area/whitesands/surface/outdoors)
"aU" = (
/turf/open/floor/plating/asteroid/whitesands/dried/lit,
/area/overmap_encounter/planetoid/sand/explored)
"aV" = (
/turf/closed/mineral/random/whitesands,
/area/whitesands/surface/outdoors)
"aW" = (
/obj/item/reagent_containers/food/drinks/waterbottle/large{
	pixel_x = -8;
	pixel_y = 2
	},
/obj/item/reagent_containers/food/snacks/canned/beans{
	pixel_x = 6;
	pixel_y = 1
	},
/turf/open/floor/mineral/plastitanium/red,
/area/ruin)
"aX" = (
/obj/item/ammo_casing/spent{
	dir = 1;
	pixel_x = -3;
	pixel_y = -2
	},
/obj/item/ammo_casing/spent{
	dir = 9;
	pixel_x = 7;
	pixel_y = 7
	},
/mob/living/simple_animal/hostile/asteroid/goliath/beast{
	dir = 8
	},
/turf/open/floor/plating/asteroid/whitesands/lit,
/area/whitesands/surface/outdoors)
"aY" = (
/obj/structure/barricade/sandbags,
/turf/open/floor/plating/asteroid/whitesands/dried/lit,
/area/whitesands/surface/outdoors)
"aZ" = (
/mob/living/simple_animal/hostile/asteroid/goliath/beast{
	dir = 8
	},
/turf/open/floor/plating/asteroid/whitesands/lit,
/area/whitesands/surface/outdoors)
"eJ" = (
/obj/item/ammo_casing/spent,
/obj/item/ammo_casing/spent{
	dir = 5;
	pixel_x = -8;
	pixel_y = 4
	},
/obj/item/ammo_casing/spent{
	dir = 1;
	pixel_x = 7;
	pixel_y = 4
	},
/turf/open/floor/plating/asteroid/whitesands/lit,
/area/overmap_encounter/planetoid/sand/explored)
"fJ" = (
/obj/structure/chair/comfy/shuttle{
	dir = 8
	},
/obj/effect/decal/cleanable/dirt/dust,
/turf/open/floor/mineral/plastitanium/red,
/area/ruin)
"gV" = (
/obj/machinery/light/directional/south,
/turf/open/floor/mineral/plastitanium/red,
/area/ruin)
"jx" = (
/obj/item/ammo_casing/spent{
	dir = 1;
	pixel_x = -3;
	pixel_y = -2
	},
/obj/item/ammo_casing/spent{
	dir = 9;
	pixel_x = 7;
	pixel_y = 7
	},
/mob/living/simple_animal/hostile/asteroid/goliath/beast{
	dir = 8
	},
/turf/open/floor/plating/asteroid/whitesands/lit,
/area/overmap_encounter/planetoid/sand/explored)
"pb" = (
/obj/effect/decal/cleanable/blood,
/obj/effect/mob_spawn/human/corpse/syndicatesoldier,
/turf/open/floor/plating/asteroid/whitesands/lit,
/area/overmap_encounter/planetoid/sand/explored)
"sL" = (
/obj/structure/chair/comfy/shuttle{
	dir = 4
	},
/obj/effect/decal/cleanable/dirt/dust,
/turf/open/floor/mineral/plastitanium/red,
/area/ruin)
"va" = (
/obj/structure/chair/comfy/shuttle{
	dir = 4
	},
/turf/open/floor/mineral/plastitanium/red,
/area/ruin)
"vh" = (
/obj/item/ammo_casing/c10mm{
	pixel_x = -1
	},
/obj/item/ammo_casing/c10mm{
	pixel_x = 7;
	pixel_y = -7
	},
/obj/item/ammo_casing/c10mm{
	pixel_x = -2;
	pixel_y = -10
	},
/obj/item/ammo_casing/c10mm{
	pixel_x = -6;
	pixel_y = -5
	},
/obj/item/ammo_casing/c10mm{
	pixel_x = -6;
	pixel_y = 4
	},
/turf/open/floor/plating/asteroid/whitesands/dried/lit,
/area/overmap_encounter/planetoid/sand/explored)
"vB" = (
/obj/effect/decal/cleanable/blood/gibs/limb{
	icon_state = "gibarm";
	pixel_x = -14;
	pixel_y = 3
	},
/obj/effect/decal/cleanable/blood{
	icon_state = "floor5";
	pixel_x = -2
	},
/turf/open/floor/plating,
/area/ruin)
"Bn" = (
/mob/living/simple_animal/hostile/asteroid/goliath/beast,
/turf/open/floor/mineral/plastitanium/red,
/area/ruin)
"Fa" = (
/turf/closed/mineral/random/whitesands,
/area/overmap_encounter/planetoid/sand/explored)
"FG" = (
/obj/effect/decal/cleanable/blood{
	icon_state = "floor7"
	},
/turf/open/floor/plating/asteroid/whitesands/dried/lit,
/area/overmap_encounter/planetoid/sand/explored)
"Hx" = (
/obj/structure/chair/comfy/shuttle{
	dir = 4
	},
/turf/closed/mineral/random/whitesands,
/area/overmap_encounter/planetoid/sand/explored)
"HX" = (
/obj/structure/barricade/sandbags,
/turf/open/floor/plating/asteroid/whitesands/lit,
/area/overmap_encounter/planetoid/sand/explored)
"Ji" = (
/obj/effect/decal/cleanable/blood/gibs/up,
/obj/effect/decal/cleanable/blood,
/obj/item/clothing/under/syndicate/intern{
	pixel_x = 1;
	pixel_y = -6
	},
/turf/open/floor/mineral/plastitanium/red,
/area/ruin)
"Ka" = (
/mob/living/simple_animal/hostile/asteroid/goliath/beast{
	dir = 8
	},
/turf/open/floor/plating/asteroid/whitesands/lit,
/area/overmap_encounter/planetoid/sand/explored)
"OI" = (
/obj/item/ammo_casing/spent,
/turf/closed/mineral/random/whitesands,
/area/overmap_encounter/planetoid/sand/explored)
"PX" = (
/obj/machinery/door/airlock/centcom{
	aiControlDisabled = 1;
	name = "Assault Pod";
	req_access_txt = "150";
	dir = 4
	},
/obj/item/ammo_casing/spent,
/turf/open/space/basic,
/area/ruin)
"Yi" = (
/obj/machinery/door/airlock/centcom{
	name = "Assault Pod";
	req_access_txt = "150"
	},
/turf/open/floor/plating,
/area/ruin)

(1,1,1) = {"
aO
aO
aO
Fa
OI
OI
OI
PX
ab
aI
aC
"}
(2,1,1) = {"
aO
aO
HX
pb
aI
Fa
Hx
aQ
aW
aI
aI
"}
(3,1,1) = {"
aO
aO
HX
jx
aI
sL
Ji
Bn
aM
as
aI
"}
(4,1,1) = {"
aO
aO
HX
aC
Yi
aQ
gV
aI
an
aQ
aN
"}
(5,1,1) = {"
aO
aO
aC
eJ
aI
fJ
aQ
va
aG
ay
aI
"}
(6,1,1) = {"
aO
aO
aC
HX
aI
aI
fJ
aQ
ax
aI
aI
"}
(7,1,1) = {"
aO
aC
aC
aC
aC
aI
aI
vB
aI
aI
aU
"}
(8,1,1) = {"
aO
aC
aC
aC
aC
HX
vh
aU
ag
aa
aO
"}
(9,1,1) = {"
aO
Ka
aC
aC
aC
HX
aa
FG
am
aC
aO
"}
(10,1,1) = {"
aO
aO
aO
aO
aO
aC
aC
aC
aC
aO
aO
"}
(11,1,1) = {"
aO
aO
aO
aO
aO
aO
aO
aO
aO
aO
aO
"}
