//MAP CONVERTED BY dmm2tgm.py THIS HEADER COMMENT PREVENTS RECONVERSION, DO NOT REMOVE
"ax" = (
/obj/item/storage/box,
/obj/item/light/bulb/broken,
/obj/item/light/tube/broken,
/obj/effect/decal/cleanable/dirt,
/turf/open/floor/plasteel,
/area/ruin/unpowered)
"aV" = (
/obj/item/resonator/upgraded,
/obj/effect/mob_spawn/human/corpse{
	mob_species = /datum/species/golem
	},
/obj/effect/decal/cleanable/blood/old,
/turf/open/floor/plating{
	icon_state = "panelscorched"
	},
/area/ruin/unpowered)
"bn" = (
/obj/item/light/bulb/broken{
	pixel_x = -13;
	pixel_y = -12
	},
/obj/item/light/tube/broken{
	pixel_x = -10;
	pixel_y = -6
	},
/obj/item/shard{
	icon_state = "small"
	},
/obj/effect/decal/cleanable/oil,
/obj/effect/decal/cleanable/dirt,
/obj/effect/decal/cleanable/blood/old,
/turf/open/floor/plasteel,
/area/ruin/unpowered)
"br" = (
/obj/effect/mob_spawn/human/corpse{
	mob_species = /datum/species/golem
	},
/obj/effect/decal/cleanable/dirt,
/obj/effect/decal/cleanable/blood/old,
/turf/open/floor/mineral/titanium/white,
/area/ruin/unpowered)
"bA" = (
/obj/effect/turf_decal/corner/transparent/neutral,
/obj/effect/turf_decal/trimline/opaque/purple/line{
	dir = 8
	},
/obj/effect/turf_decal/corner/transparent/neutral{
	dir = 4
	},
/obj/effect/turf_decal/corner/transparent/neutral,
/obj/effect/decal/cleanable/dirt,
/turf/open/floor/plasteel/dark,
/area/ruin/unpowered)
"cA" = (
/turf/closed/wall/mineral/titanium/nodiagonal,
/area/ruin/unpowered)
"cX" = (
/obj/machinery/door/airlock/titanium,
/turf/open/floor/plasteel/dark,
/area/ruin/unpowered)
"dy" = (
/obj/structure/reagent_dispensers/fueltank,
/obj/effect/decal/cleanable/oil/slippery,
/turf/open/floor/plasteel/dark,
/area/ruin/unpowered)
"dU" = (
/obj/effect/turf_decal/corner/transparent/neutral,
/obj/effect/turf_decal/corner/transparent/neutral{
	dir = 4
	},
/obj/effect/turf_decal/trimline/opaque/white/line{
	dir = 8
	},
/obj/structure/table,
/obj/item/storage/firstaid/brute,
/turf/open/floor/plasteel/dark,
/area/ruin/unpowered)
"dW" = (
/obj/structure/table,
/obj/effect/decal/cleanable/blood/old,
/turf/open/floor/plating,
/area/ruin/unpowered)
"ee" = (
/obj/effect/decal/cleanable/dirt,
/turf/open/floor/plating{
	icon_state = "platingdmg1"
	},
/area/ruin/unpowered)
"fK" = (
/obj/item/light/tube/broken{
	pixel_x = -10;
	pixel_y = -7
	},
/turf/open/floor/plating{
	icon_state = "panelscorched"
	},
/area/ruin/unpowered)
"fL" = (
/obj/item/resonator,
/obj/effect/decal/cleanable/blood/old,
/turf/open/floor/plating{
	icon_state = "platingdmg1"
	},
/area/ruin/unpowered)
"gj" = (
/obj/item/stack/sheet/mineral/wood,
/obj/item/stack/sheet/mineral/wood,
/obj/item/stack/sheet/mineral/wood,
/obj/item/stack/sheet/mineral/wood,
/obj/item/mining_scanner{
	pixel_x = -7;
	pixel_y = 5
	},
/turf/open/floor/mineral/plastitanium,
/area/overmap_encounter/planetoid/sand/explored)
"gp" = (
/obj/structure/rack,
/obj/item/storage/toolbox/electrical{
	pixel_x = -3;
	pixel_y = 3
	},
/obj/item/storage/toolbox/mechanical,
/obj/item/storage/toolbox/emergency{
	pixel_x = 3;
	pixel_y = -3
	},
/turf/open/floor/plating{
	icon_state = "platingdmg1"
	},
/area/ruin/unpowered)
"gM" = (
/obj/item/light/bulb/broken{
	pixel_x = 3;
	pixel_y = -1
	},
/turf/open/floor/plating{
	icon_state = "platingdmg1"
	},
/area/ruin/unpowered)
"hq" = (
/obj/structure/rack,
/obj/item/spear,
/obj/item/shard{
	icon_state = "medium"
	},
/obj/item/shard{
	icon_state = "tiny"
	},
/obj/item/shard{
	icon_state = "small"
	},
/turf/open/floor/plasteel/dark,
/area/ruin/unpowered)
"hr" = (
/obj/effect/turf_decal/corner/transparent/neutral{
	dir = 8
	},
/obj/effect/turf_decal/corner/transparent/neutral{
	dir = 1
	},
/obj/effect/turf_decal/trimline/opaque/purple/line{
	dir = 4
	},
/obj/effect/decal/cleanable/dirt,
/turf/open/floor/plasteel/dark,
/area/ruin/unpowered)
"hC" = (
/obj/item/mining_scanner{
	pixel_y = 7
	},
/obj/effect/decal/cleanable/dirt,
/turf/open/floor/mineral/titanium/yellow,
/area/overmap_encounter/planetoid/sand/explored)
"ig" = (
/obj/effect/decal/cleanable/dirt,
/turf/open/floor/plating{
	icon_state = "platingdmg1"
	},
/area/overmap_encounter/planetoid/sand/explored)
"ih" = (
/obj/structure/girder/displaced,
/turf/open/floor/plating{
	icon_state = "platingdmg1"
	},
/area/ruin/unpowered)
"ik" = (
/turf/open/floor/plating{
	icon_state = "platingdmg2"
	},
/area/ruin/unpowered)
"ir" = (
/obj/structure/girder,
/turf/open/floor/plating,
/area/ruin/unpowered)
"iC" = (
/obj/item/spear,
/obj/effect/mob_spawn/human/corpse{
	mob_species = /datum/species/lizard/ashwalker
	},
/obj/effect/decal/cleanable/dirt,
/obj/effect/decal/cleanable/blood/old,
/turf/open/floor/plating{
	icon_state = "platingdmg1"
	},
/area/ruin/unpowered)
"jg" = (
/obj/item/light/bulb/broken{
	pixel_x = 8;
	pixel_y = 8
	},
/obj/item/light/tube/broken{
	pixel_x = -10;
	pixel_y = 6
	},
/obj/effect/decal/cleanable/oil,
/obj/effect/decal/cleanable/dirt,
/obj/effect/decal/cleanable/blood/old,
/turf/open/floor/plasteel,
/area/ruin/unpowered)
"jv" = (
/obj/effect/decal/cleanable/dirt,
/turf/open/floor/plating,
/area/ruin/unpowered)
"jW" = (
/obj/effect/turf_decal/corner/transparent/neutral,
/obj/effect/turf_decal/corner/transparent/neutral{
	dir = 8
	},
/obj/effect/turf_decal/trimline/opaque/white/corner{
	dir = 1
	},
/obj/structure/table,
/obj/item/areaeditor/blueprints{
	desc = "Use to build new structures in the wastes.";
	name = "land claim"
	},
/obj/effect/decal/cleanable/blood/old,
/turf/open/floor/plasteel/dark,
/area/ruin/unpowered)
"kv" = (
/obj/structure/reagent_dispensers/watertank,
/turf/open/floor/plating,
/area/ruin/unpowered)
"ky" = (
/obj/structure/frame/machine,
/obj/effect/decal/cleanable/dirt,
/turf/open/floor/plasteel/dark,
/area/ruin/unpowered)
"kE" = (
/obj/structure/reagent_dispensers/watertank,
/obj/effect/decal/cleanable/oil/slippery,
/turf/open/floor/plating{
	icon_state = "platingdmg1"
	},
/area/ruin/unpowered)
"kO" = (
/obj/item/light/bulb/broken{
	pixel_x = -3;
	pixel_y = -9
	},
/obj/item/shard{
	icon_state = "medium"
	},
/obj/effect/decal/cleanable/oil,
/obj/effect/decal/cleanable/dirt,
/turf/open/floor/plasteel,
/area/ruin/unpowered)
"lk" = (
/obj/effect/turf_decal/corner/transparent/neutral{
	dir = 4
	},
/obj/effect/turf_decal/corner/transparent/neutral,
/obj/effect/turf_decal/trimline/opaque/purple/line{
	dir = 8
	},
/obj/effect/decal/cleanable/dirt,
/turf/open/floor/plasteel/dark,
/area/ruin/unpowered)
"lN" = (
/obj/machinery/door/airlock/titanium,
/turf/open/floor/plating/asteroid/whitesands,
/area/ruin/unpowered)
"lP" = (
/obj/item/storage/bag/ore,
/obj/effect/turf_decal/industrial/outline/yellow,
/obj/effect/turf_decal/trimline/opaque/yellow/line{
	dir = 8
	},
/obj/effect/turf_decal/corner/transparent/neutral{
	dir = 4
	},
/obj/effect/turf_decal/corner/transparent/neutral,
/obj/item/rack_parts,
/obj/item/resonator{
	pixel_x = -6;
	pixel_y = -6
	},
/turf/open/floor/mineral/plastitanium,
/area/overmap_encounter/planetoid/sand/explored)
"nh" = (
/obj/item/light/bulb/broken{
	pixel_x = 7;
	pixel_y = 7
	},
/obj/item/light/tube/broken{
	pixel_x = 12;
	pixel_y = -7
	},
/obj/effect/decal/cleanable/oil/streak,
/obj/effect/decal/cleanable/dirt,
/turf/open/floor/plasteel,
/area/ruin/unpowered)
"nS" = (
/obj/structure/door_assembly/door_assembly_min{
	dir = 4
	},
/turf/open/floor/plating,
/area/ruin/unpowered)
"nV" = (
/obj/effect/decal/cleanable/dirt,
/turf/open/floor/mineral/titanium/purple,
/area/ruin/unpowered)
"ow" = (
/obj/machinery/door/airlock/external,
/turf/open/floor/plasteel/dark,
/area/ruin/unpowered)
"pe" = (
/obj/effect/turf_decal/corner/transparent/neutral{
	dir = 8
	},
/obj/effect/turf_decal/trimline/opaque/white/line{
	dir = 5
	},
/obj/effect/decal/cleanable/dirt,
/turf/open/floor/plasteel/dark,
/area/ruin/unpowered)
"pk" = (
/obj/structure/frame/machine,
/turf/open/floor/plating,
/area/ruin/unpowered)
"py" = (
/obj/item/pickaxe,
/obj/effect/decal/cleanable/dirt,
/obj/effect/decal/cleanable/blood/old,
/turf/open/floor/mineral/titanium/white,
/area/ruin/unpowered)
"qg" = (
/turf/open/floor/plating,
/area/ruin/unpowered)
"qp" = (
/turf/open/floor/mineral/titanium/purple,
/area/ruin/unpowered)
"qK" = (
/obj/structure/AIcore/deactivated,
/turf/open/floor/mineral/titanium/white,
/area/ruin/unpowered)
"rq" = (
/obj/item/storage/box/rndboards,
/obj/effect/decal/cleanable/dirt,
/obj/effect/decal/cleanable/blood/old,
/turf/open/floor/mineral/titanium/white,
/area/ruin/unpowered)
"rv" = (
/obj/item/rack_parts,
/obj/item/storage/bag/ore,
/turf/open/floor/plating,
/area/overmap_encounter/planetoid/sand/explored)
"rI" = (
/obj/item/shard{
	icon_state = "tiny"
	},
/turf/open/floor/plating,
/area/ruin/unpowered)
"rX" = (
/turf/open/floor/plating{
	icon_state = "platingdmg1"
	},
/area/overmap_encounter/planetoid/sand/explored)
"sq" = (
/obj/item/light/bulb/broken{
	pixel_x = -4;
	pixel_y = -4
	},
/obj/effect/decal/cleanable/dirt,
/turf/open/floor/plasteel,
/area/ruin/unpowered)
"sw" = (
/obj/item/shard{
	icon_state = "tiny"
	},
/obj/item/shard,
/obj/item/shard{
	icon_state = "small"
	},
/turf/open/floor/plating,
/area/ruin/unpowered)
"sE" = (
/obj/effect/spawner/structure/window/shuttle,
/turf/open/floor/plating,
/area/ruin/unpowered)
"sP" = (
/obj/item/shard{
	icon_state = "tiny"
	},
/obj/item/shard{
	icon_state = "medium"
	},
/obj/effect/decal/cleanable/dirt,
/turf/open/floor/plating{
	icon_state = "platingdmg1"
	},
/area/ruin/unpowered)
"sV" = (
/obj/effect/decal/cleanable/dirt,
/obj/effect/decal/cleanable/blood/old,
/turf/open/floor/mineral/titanium/purple,
/area/ruin/unpowered)
"tN" = (
/obj/structure/rack,
/obj/item/pickaxe,
/turf/open/floor/mineral/plastitanium,
/area/overmap_encounter/planetoid/sand/explored)
"tO" = (
/obj/structure/door_assembly/door_assembly_com,
/turf/open/floor/plating{
	icon_state = "panelscorched"
	},
/area/ruin/unpowered)
"uh" = (
/obj/effect/decal/cleanable/dirt,
/turf/open/floor/plasteel,
/area/ruin/unpowered)
"uK" = (
/turf/open/floor/plating/asteroid/whitesands,
/area/overmap_encounter/planetoid/sand/explored)
"uR" = (
/obj/item/shard{
	icon_state = "medium"
	},
/turf/open/floor/plating/asteroid/whitesands,
/area/overmap_encounter/planetoid/sand/explored)
"vy" = (
/obj/item/resonator,
/obj/effect/mob_spawn/human/corpse{
	mob_species = /datum/species/golem
	},
/obj/effect/decal/cleanable/dirt,
/obj/effect/decal/cleanable/blood/old,
/turf/open/floor/mineral/titanium/purple,
/area/ruin/unpowered)
"wq" = (
/obj/item/pickaxe,
/turf/open/floor/plating,
/area/ruin/unpowered)
"wV" = (
/obj/effect/turf_decal/corner/transparent/neutral{
	dir = 1
	},
/obj/effect/turf_decal/corner/transparent/neutral{
	dir = 8
	},
/obj/effect/turf_decal/trimline/opaque/white/corner{
	dir = 4
	},
/obj/effect/decal/cleanable/dirt,
/obj/effect/turf_decal/trimline/opaque/white/corner,
/turf/open/floor/plasteel/dark,
/area/ruin/unpowered)
"zF" = (
/turf/template_noop,
/area/template_noop)
"zL" = (
/obj/item/storage/part_replacer/bluespace/tier2,
/turf/open/floor/mineral/titanium/white,
/area/ruin/unpowered)
"zX" = (
/obj/effect/turf_decal/corner/transparent/neutral,
/obj/effect/turf_decal/trimline/opaque/white/line{
	dir = 9
	},
/obj/structure/table,
/obj/structure/frame/machine,
/obj/item/stack/cable_coil/cut/green,
/obj/item/circuitboard/machine/reagentgrinder,
/turf/open/floor/plasteel/dark,
/area/ruin/unpowered)
"Ah" = (
/turf/closed/wall/mineral/plastitanium,
/area/ruin/unpowered)
"AT" = (
/obj/item/shard,
/obj/effect/turf_decal/corner/transparent/neutral{
	dir = 4
	},
/obj/effect/turf_decal/corner/transparent/neutral,
/obj/effect/turf_decal/trimline/opaque/purple/line{
	dir = 8
	},
/obj/effect/decal/cleanable/dirt,
/turf/open/floor/plasteel/dark,
/area/ruin/unpowered)
"BK" = (
/turf/open/floor/plating/asteroid/whitesands,
/area/ruin/unpowered)
"BO" = (
/obj/item/shard{
	icon_state = "small"
	},
/obj/effect/decal/cleanable/dirt,
/turf/open/floor/plating{
	icon_state = "platingdmg1"
	},
/area/ruin/unpowered)
"CA" = (
/obj/effect/decal/cleanable/dirt,
/turf/open/floor/mineral/titanium/white,
/area/ruin/unpowered)
"CQ" = (
/obj/machinery/washing_machine,
/turf/open/floor/plating{
	icon_state = "platingdmg1"
	},
/area/ruin/unpowered)
"Dc" = (
/obj/effect/turf_decal/corner/transparent/neutral{
	dir = 1
	},
/obj/effect/turf_decal/corner/transparent/neutral{
	dir = 8
	},
/obj/effect/turf_decal/trimline/opaque/purple/line{
	dir = 4
	},
/turf/open/floor/plasteel/dark,
/area/ruin/unpowered)
"Di" = (
/turf/open/floor/plating{
	icon_state = "platingdmg2"
	},
/area/overmap_encounter/planetoid/sand/explored)
"Dn" = (
/obj/effect/turf_decal/corner/transparent/neutral{
	dir = 1
	},
/obj/effect/turf_decal/corner/transparent/neutral{
	dir = 8
	},
/obj/effect/turf_decal/trimline/opaque/white/line{
	dir = 4
	},
/obj/structure/frame/machine,
/obj/item/stack/cable_coil/cut/random,
/obj/item/surgicaldrill/advanced,
/turf/open/floor/plasteel/dark,
/area/ruin/unpowered)
"EG" = (
/obj/structure/frame/machine,
/obj/effect/decal/cleanable/oil,
/obj/item/stack/cable_coil/cut/random,
/obj/item/clothing/suit/space/hardsuit/mining,
/turf/open/floor/plating{
	icon_state = "platingdmg1"
	},
/area/ruin/unpowered)
"EJ" = (
/obj/structure/table,
/turf/open/floor/plating{
	icon_state = "panelscorched"
	},
/area/ruin/unpowered)
"Fg" = (
/obj/effect/turf_decal/trimline/opaque/purple/line{
	dir = 5
	},
/obj/effect/turf_decal/trimline/opaque/purple/corner{
	dir = 8
	},
/obj/item/shard{
	icon_state = "tiny"
	},
/obj/item/shard{
	icon_state = "small"
	},
/obj/effect/mob_spawn/human/corpse{
	mob_species = /datum/species/golem
	},
/turf/open/floor/plasteel/dark,
/area/ruin/unpowered)
"Gt" = (
/obj/machinery/light/small/directional/west,
/obj/effect/decal/cleanable/dirt,
/turf/open/floor/plasteel/freezer,
/area/overmap_encounter/planetoid/sand/explored)
"GC" = (
/turf/open/floor/plating{
	icon_state = "platingdmg1"
	},
/area/ruin/unpowered)
"Jh" = (
/obj/effect/decal/cleanable/blood/old,
/turf/open/floor/plating{
	icon_state = "platingdmg1"
	},
/area/ruin/unpowered)
"Jj" = (
/obj/item/card/id/mining,
/turf/open/floor/plating{
	icon_state = "platingdmg1"
	},
/area/overmap_encounter/planetoid/sand/explored)
"Jl" = (
/obj/structure/door_assembly/door_assembly_com,
/turf/open/floor/plating{
	icon_state = "platingdmg1"
	},
/area/ruin/unpowered)
"JM" = (
/obj/effect/turf_decal/corner/transparent/neutral{
	dir = 4
	},
/obj/effect/turf_decal/corner/transparent/neutral,
/obj/effect/turf_decal/trimline/opaque/white/line{
	dir = 8
	},
/obj/machinery/autolathe,
/obj/effect/decal/cleanable/dirt,
/turf/open/floor/plasteel/dark,
/area/ruin/unpowered)
"JX" = (
/obj/structure/rack,
/obj/item/mop,
/obj/item/reagent_containers/glass/bucket,
/obj/item/storage/bag/trash{
	pixel_x = 6
	},
/turf/open/floor/plating,
/area/ruin/unpowered)
"Kk" = (
/obj/machinery/door/airlock/titanium,
/obj/effect/turf_decal/industrial/warning,
/obj/effect/turf_decal/industrial/warning{
	dir = 1
	},
/turf/open/floor/plasteel/dark,
/area/ruin/unpowered)
"KW" = (
/obj/item/rack_parts,
/turf/open/floor/plating/asteroid/whitesands,
/area/overmap_encounter/planetoid/sand/explored)
"KX" = (
/obj/structure/rack,
/obj/effect/turf_decal/trimline/opaque/yellow/line{
	dir = 8
	},
/obj/effect/turf_decal/corner/transparent/neutral{
	dir = 4
	},
/obj/effect/turf_decal/corner/transparent/neutral,
/obj/effect/turf_decal/industrial/outline/yellow,
/obj/item/clothing/head/hardhat/mining{
	pixel_x = -6;
	pixel_y = -6
	},
/obj/item/clothing/head/hardhat/mining{
	pixel_x = -2;
	pixel_y = -2
	},
/obj/item/clothing/head/hardhat/mining{
	pixel_x = 6;
	pixel_y = 6
	},
/turf/open/floor/mineral/plastitanium,
/area/overmap_encounter/planetoid/sand/explored)
"Ln" = (
/obj/structure/girder,
/turf/open/floor/plating{
	icon_state = "platingdmg1"
	},
/area/ruin/unpowered)
"Lp" = (
/turf/open/floor/plating{
	icon_state = "panelscorched"
	},
/area/overmap_encounter/planetoid/sand/explored)
"LG" = (
/obj/item/rack_parts,
/turf/open/floor/mineral/plastitanium,
/area/overmap_encounter/planetoid/sand/explored)
"MY" = (
/obj/effect/turf_decal/trimline/opaque/white/corner{
	dir = 4
	},
/obj/effect/turf_decal/corner/transparent/neutral{
	dir = 8
	},
/obj/effect/turf_decal/corner/transparent/neutral,
/obj/machinery/mecha_part_fabricator/maint,
/turf/open/floor/plasteel/dark,
/area/ruin/unpowered)
"Nu" = (
/obj/item/pickaxe{
	pixel_x = -6;
	pixel_y = 17
	},
/obj/item/mining_scanner,
/turf/open/floor/plating{
	icon_state = "panelscorched"
	},
/area/overmap_encounter/planetoid/sand/explored)
"NC" = (
/obj/structure/frame/machine,
/turf/open/floor/plasteel/dark,
/area/ruin/unpowered)
"NR" = (
/obj/item/pickaxe{
	pixel_x = 3;
	pixel_y = -3
	},
/obj/item/card/id/mining,
/obj/effect/decal/cleanable/dirt,
/turf/open/floor/mineral/titanium/yellow,
/area/overmap_encounter/planetoid/sand/explored)
"OU" = (
/obj/structure/window/reinforced,
/obj/structure/shuttle/engine/heater{
	dir = 1
	},
/turf/open/floor/plating,
/area/ruin/unpowered)
"Ps" = (
/obj/item/shard{
	icon_state = "tiny"
	},
/obj/item/shard{
	icon_state = "small"
	},
/turf/open/floor/plating,
/area/ruin/unpowered)
"PE" = (
/obj/machinery/cell_charger,
/obj/effect/decal/cleanable/dirt,
/turf/open/floor/mineral/titanium/purple,
/area/ruin/unpowered)
"PI" = (
/obj/structure/ore_box,
/turf/open/floor/mineral/plastitanium,
/area/overmap_encounter/planetoid/sand/explored)
"Rg" = (
/obj/effect/turf_decal/trimline/opaque/purple/line{
	dir = 8
	},
/obj/effect/turf_decal/corner/transparent/neutral,
/obj/effect/turf_decal/corner/transparent/neutral{
	dir = 4
	},
/obj/effect/decal/cleanable/dirt,
/turf/open/floor/plasteel/dark,
/area/ruin/unpowered)
"Rp" = (
/obj/effect/decal/cleanable/oil/streak,
/obj/effect/decal/cleanable/dirt,
/turf/open/floor/plasteel,
/area/ruin/unpowered)
"RW" = (
/obj/item/shard{
	icon_state = "tiny"
	},
/obj/item/shard{
	icon_state = "small"
	},
/obj/effect/decal/cleanable/dirt,
/turf/open/floor/plating{
	icon_state = "platingdmg1"
	},
/area/ruin/unpowered)
"Sf" = (
/obj/structure/girder/displaced,
/turf/open/floor/plating,
/area/ruin/unpowered)
"Sm" = (
/obj/effect/decal/cleanable/dirt,
/obj/effect/decal/cleanable/blood/old,
/turf/open/floor/plasteel/dark,
/area/ruin/unpowered)
"Su" = (
/obj/item/shard,
/obj/effect/decal/cleanable/dirt,
/turf/open/floor/plating{
	icon_state = "platingdmg1"
	},
/area/ruin/unpowered)
"SZ" = (
/obj/structure/girder/displaced,
/turf/open/floor/plating{
	icon_state = "panelscorched"
	},
/area/overmap_encounter/planetoid/sand/explored)
"TM" = (
/obj/item/bedsheet/rd/royal_cape,
/obj/item/toy/figure/rd{
	name = "the Liberator action figure";
	pixel_x = 7;
	pixel_y = -5;
	toysay = "Yeah, go do whatever."
	},
/obj/effect/decal/cleanable/blood/old,
/turf/open/floor/plating,
/area/ruin/unpowered)
"TN" = (
/turf/open/floor/plating{
	icon_state = "panelscorched"
	},
/area/ruin/unpowered)
"TO" = (
/obj/structure/girder,
/turf/open/floor/plating,
/area/overmap_encounter/planetoid/sand/explored)
"Ub" = (
/obj/structure/rack,
/obj/item/card/id/mining,
/obj/item/clothing/head/hardhat/mining,
/turf/open/floor/plating{
	icon_state = "platingdmg1"
	},
/area/overmap_encounter/planetoid/sand/explored)
"Ui" = (
/obj/item/crowbar,
/turf/open/floor/plating{
	icon_state = "platingdmg1"
	},
/area/overmap_encounter/planetoid/sand/explored)
"Up" = (
/obj/effect/decal/cleanable/dirt,
/turf/open/floor/plasteel/freezer,
/area/overmap_encounter/planetoid/sand/explored)
"Uw" = (
/obj/machinery/door/airlock/titanium,
/turf/open/floor/plating,
/area/ruin/unpowered)
"UJ" = (
/obj/effect/turf_decal/corner/transparent/neutral{
	dir = 8
	},
/obj/effect/turf_decal/corner/transparent/neutral{
	dir = 1
	},
/turf/open/floor/plating/asteroid/whitesands,
/area/ruin/unpowered)
"VJ" = (
/obj/item/toy/plush/lizardplushie{
	desc = "Awww! It looks like it will snuggle all of your internal organs!";
	name = "ashwalker plushie"
	},
/obj/effect/mob_spawn/human/corpse{
	mob_species = /datum/species/lizard/ashwalker
	},
/obj/effect/decal/cleanable/dirt,
/obj/effect/decal/cleanable/blood/old,
/turf/open/floor/mineral/titanium/white,
/area/ruin/unpowered)
"VK" = (
/obj/effect/turf_decal/industrial/outline/yellow,
/obj/effect/turf_decal/corner/transparent/neutral,
/obj/effect/turf_decal/trimline/opaque/yellow/line{
	dir = 8
	},
/obj/effect/turf_decal/corner/transparent/neutral{
	dir = 4
	},
/turf/open/floor/mineral/plastitanium,
/area/overmap_encounter/planetoid/sand/explored)
"We" = (
/obj/item/mining_scanner,
/turf/open/floor/plating{
	icon_state = "platingdmg1"
	},
/area/overmap_encounter/planetoid/sand/explored)
"WH" = (
/obj/item/spear/bonespear,
/turf/open/floor/plating{
	icon_state = "platingdmg1"
	},
/area/ruin/unpowered)
"WR" = (
/obj/structure/frame/machine,
/obj/item/shard,
/obj/item/book/manual/wiki/research_and_development{
	name = "Sacred Text of the Liberator";
	pixel_y = -5
	},
/turf/open/floor/plating{
	icon_state = "platingdmg1"
	},
/area/ruin/unpowered)
"Xn" = (
/obj/machinery/mineral/ore_redemption{
	input_dir = 4;
	output_dir = 8
	},
/turf/open/floor/plating,
/area/ruin/unpowered)
"Ye" = (
/obj/machinery/shower,
/obj/effect/decal/cleanable/dirt,
/turf/open/floor/plasteel/freezer,
/area/overmap_encounter/planetoid/sand/explored)
"Yl" = (
/obj/item/storage/box,
/obj/structure/table,
/obj/item/light/bulb/broken,
/obj/item/light/tube/broken{
	pixel_x = -1;
	pixel_y = 5
	},
/obj/item/shard,
/obj/effect/mob_spawn/human/corpse{
	mob_species = /datum/species/lizard/ashwalker
	},
/obj/effect/decal/cleanable/blood/old,
/turf/open/floor/plasteel/dark,
/area/ruin/unpowered)
"Zs" = (
/obj/structure/shuttle/engine/propulsion{
	dir = 1
	},
/turf/open/floor/plating,
/area/ruin/unpowered)
"Zu" = (
/turf/open/floor/plasteel/dark,
/area/ruin/unpowered)
"ZK" = (
/obj/structure/shuttle/engine/heater{
	dir = 1
	},
/obj/structure/window/reinforced,
/turf/open/floor/plating,
/area/ruin/unpowered)

(1,1,1) = {"
zF
zF
zF
sE
sE
cA
cA
Ln
cA
ir
uK
zF
zF
zF
zF
zF
zF
zF
zF
zF
zF
zF
zF
"}
(2,1,1) = {"
Ah
Ah
cA
sE
kv
JX
gp
ir
Gt
rX
uK
uK
zF
zF
zF
zF
zF
zF
zF
zF
zF
zF
zF
"}
(3,1,1) = {"
Zs
OU
cA
CQ
jv
jv
BK
cA
Ye
Lp
rX
TO
uK
zF
zF
zF
zF
zF
zF
zF
zF
zF
zF
"}
(4,1,1) = {"
Zs
OU
cA
dW
iC
BK
BK
Uw
Up
uK
Lp
uK
uK
uK
zF
zF
zF
zF
zF
zF
zF
zF
zF
"}
(5,1,1) = {"
Ah
Ah
ih
Ln
cX
ih
wq
Ln
rX
Lp
ig
SZ
uR
uK
zF
zF
zF
zF
zF
zF
zF
zF
zF
"}
(6,1,1) = {"
Zs
OU
GC
qg
BK
cA
cA
cA
cA
cA
cA
cA
cA
rI
rI
cA
Uw
Uw
cA
cA
uK
zF
zF
"}
(7,1,1) = {"
Zs
OU
Ln
BK
gM
TN
ih
zX
dU
EJ
JM
GC
AT
bA
Rg
GC
jv
lk
ee
Sf
uK
uK
zF
"}
(8,1,1) = {"
cA
cA
cA
pk
aV
Sm
cA
jW
fL
CA
CA
GC
GC
nV
nV
TM
ee
Su
ee
tO
Ui
Lp
uK
"}
(9,1,1) = {"
ow
Zu
ow
uh
nh
fK
Kk
Jh
br
GC
qK
py
qp
PE
ky
nV
BO
RW
RW
Sf
Di
uK
Di
"}
(10,1,1) = {"
ow
Zu
ow
sq
ax
jg
Kk
CA
CA
VJ
qg
rq
GC
nV
NC
sV
WR
Fg
sP
ir
uK
rX
rX
"}
(11,1,1) = {"
cA
cA
cA
EG
bn
Yl
cA
MY
CA
WH
CA
zL
ik
vy
GC
ee
ee
ee
ee
Jl
rX
Lp
uK
"}
(12,1,1) = {"
Zs
ZK
cA
kE
kO
hq
cA
pe
GC
wV
Dn
GC
Dc
hr
UJ
ee
hr
ee
GC
rX
uK
uK
uK
"}
(13,1,1) = {"
Zs
ZK
cA
dy
Rp
cA
cA
cA
cA
nS
cA
Xn
sw
cA
cA
cA
nS
Ps
Sf
uK
zF
zF
zF
"}
(14,1,1) = {"
Ah
Ah
cA
cA
lN
cA
KX
lP
Jj
VK
uK
uK
uK
zF
zF
zF
zF
zF
zF
zF
zF
zF
zF
"}
(15,1,1) = {"
Zs
OU
cA
PI
hC
rX
We
uK
uK
uK
zF
zF
zF
zF
zF
zF
zF
zF
zF
zF
zF
zF
zF
"}
(16,1,1) = {"
Zs
OU
cA
gj
NR
Nu
rX
Jj
uK
zF
zF
zF
zF
zF
zF
zF
zF
zF
zF
zF
zF
zF
zF
"}
(17,1,1) = {"
Ah
Ah
cA
cA
tN
rv
LG
Ub
KW
zF
zF
zF
zF
zF
zF
zF
zF
zF
zF
zF
zF
zF
zF
"}
(18,1,1) = {"
zF
zF
zF
cA
cA
uK
uK
zF
zF
zF
zF
zF
zF
zF
zF
zF
zF
zF
zF
zF
zF
zF
zF
"}
