//MAP CONVERTED BY dmm2tgm.py THIS HEADER COMMENT PREVENTS RECONVERSION, DO NOT REMOVE
"ab" = (
/turf/open/floor/plating{
	icon_state = "panelscorched";
	initial_gas_mix = "ws_atmos"
	},
/area/overmap_encounter/planetoid/cave/explored)
"af" = (
/obj/machinery/atmospherics/pipe/simple/scrubbers{
	dir = 10
	},
/turf/open/floor/plating{
	icon_state = "platingdmg1";
	initial_gas_mix = "ws_atmos"
	},
/area/overmap_encounter/planetoid/cave/explored)
"aA" = (
/obj/item/stack/sheet/metal,
/turf/open/floor/plating{
	icon_state = "platingdmg1";
	initial_gas_mix = "ws_atmos"
	},
/area/overmap_encounter/planetoid/cave/explored)
"bc" = (
/obj/machinery/atmospherics/pipe/manifold/scrubbers/visible{
	dir = 1
	},
/turf/open/floor/plating/asteroid/whitesands,
/area/overmap_encounter/planetoid/cave/explored)
"cn" = (
/obj/structure/frame/machine,
/obj/item/circuitboard/machine/sleeper,
/turf/open/floor/plating{
	icon_state = "panelscorched";
	initial_gas_mix = "ws_atmos"
	},
/area/overmap_encounter/planetoid/cave/explored)
"cF" = (
/obj/structure/safe/floor,
/obj/item/clothing/suit/space/hardsuit/syndi,
/obj/item/documents/syndicate,
/turf/open/floor/plating{
	icon_state = "panelscorched";
	initial_gas_mix = "ws_atmos"
	},
/area/overmap_encounter/planetoid/cave/explored)
"cK" = (
/obj/structure/frame/machine,
/obj/item/stack/cable_coil/cut/blue,
/turf/open/floor/mineral/plastitanium/red{
	initial_gas_mix = "ws_atmos"
	},
/area/overmap_encounter/planetoid/cave/explored)
"cL" = (
/turf/open/floor/plating{
	icon_state = "platingdmg1"
	},
/area/overmap_encounter/planetoid/cave/explored)
"cM" = (
/obj/machinery/suit_storage_unit,
/turf/open/floor/plating{
	initial_gas_mix = "ws_atmos"
	},
/area/overmap_encounter/planetoid/cave/explored)
"dk" = (
/obj/machinery/atmospherics/pipe/simple/scrubbers{
	dir = 8
	},
/turf/open/floor/plating{
	icon_state = "panelscorched";
	initial_gas_mix = "ws_atmos"
	},
/area/overmap_encounter/planetoid/cave/explored)
"do" = (
/obj/machinery/atmospherics/pipe/manifold/cyan/visible{
	dir = 8
	},
/turf/open/floor/plating{
	initial_gas_mix = "ws_atmos"
	},
/area/overmap_encounter/planetoid/cave/explored)
"dt" = (
/obj/effect/turf_decal/corner/opaque/blue,
/obj/effect/turf_decal/corner/opaque/blue{
	dir = 8
	},
/turf/open/floor/plasteel/dark,
/area/overmap_encounter/planetoid/cave/explored)
"dA" = (
/obj/machinery/atmospherics/pipe/simple/scrubbers,
/turf/open/floor/plating{
	icon_state = "platingdmg1";
	initial_gas_mix = "ws_atmos"
	},
/area/overmap_encounter/planetoid/cave/explored)
"dU" = (
/obj/machinery/portable_atmospherics/scrubber,
/turf/open/floor/plating{
	icon_state = "platingdmg1";
	initial_gas_mix = "ws_atmos"
	},
/area/overmap_encounter/planetoid/cave/explored)
"dW" = (
/obj/machinery/portable_atmospherics/scrubber,
/turf/open/floor/plating/asteroid/whitesands,
/area/overmap_encounter/planetoid/cave/explored)
"em" = (
/obj/effect/turf_decal/industrial/traffic{
	dir = 8
	},
/turf/open/floor/plating{
	initial_gas_mix = "ws_atmos"
	},
/area/overmap_encounter/planetoid/cave/explored)
"eH" = (
/obj/machinery/atmospherics/pipe/simple/dark/visible{
	dir = 8
	},
/turf/open/floor/plating{
	icon_state = "platingdmg1";
	initial_gas_mix = "ws_atmos"
	},
/area/overmap_encounter/planetoid/cave/explored)
"ff" = (
/obj/effect/turf_decal/industrial/warning/corner{
	dir = 4
	},
/obj/machinery/atmospherics/pipe/simple/scrubbers{
	dir = 6
	},
/turf/open/floor/engine{
	initial_gas_mix = "ws_atmos"
	},
/area/overmap_encounter/planetoid/cave/explored)
"fh" = (
/obj/machinery/atmospherics/pipe/manifold/scrubbers/visible{
	dir = 4
	},
/turf/open/floor/plating{
	icon_state = "platingdmg1";
	initial_gas_mix = "ws_atmos"
	},
/area/overmap_encounter/planetoid/cave/explored)
"fq" = (
/obj/machinery/atmospherics/pipe/manifold/scrubbers/visible,
/turf/open/floor/plating{
	icon_state = "platingdmg1";
	initial_gas_mix = "ws_atmos"
	},
/area/overmap_encounter/planetoid/cave/explored)
"fv" = (
/obj/effect/turf_decal/radiation,
/turf/open/floor/plasteel/dark,
/area/overmap_encounter/planetoid/cave/explored)
"fE" = (
/obj/item/stack/sheet/metal,
/obj/item/stack/sheet/metal,
/obj/item/stack/sheet/metal,
/obj/machinery/atmospherics/pipe/simple/cyan/visible{
	dir = 8
	},
/turf/open/floor/plating{
	icon_state = "platingdmg1";
	initial_gas_mix = "ws_atmos"
	},
/area/overmap_encounter/planetoid/cave/explored)
"fP" = (
/obj/machinery/door/airlock/hatch,
/turf/open/floor/plasteel/dark,
/area/overmap_encounter/planetoid/cave/explored)
"gw" = (
/obj/effect/turf_decal/corner/opaque/yellow{
	dir = 4
	},
/turf/open/floor/plasteel/dark,
/area/overmap_encounter/planetoid/cave/explored)
"gP" = (
/obj/machinery/power/smes,
/turf/open/floor/plating{
	icon_state = "panelscorched"
	},
/area/overmap_encounter/planetoid/cave/explored)
"gY" = (
/mob/living/simple_animal/hostile/syndicate/ranged/space,
/turf/open/floor/plating{
	initial_gas_mix = "ws_atmos"
	},
/area/overmap_encounter/planetoid/cave/explored)
"hg" = (
/obj/machinery/suit_storage_unit{
	mask_type = /obj/item/clothing/mask/gas/syndicate;
	storage_type = null
	},
/turf/open/floor/mineral/plastitanium/red{
	initial_gas_mix = "ws_atmos"
	},
/area/overmap_encounter/planetoid/cave/explored)
"ir" = (
/obj/machinery/door/airlock/engineering{
	dir = 4
	},
/turf/open/floor/plating,
/area/overmap_encounter/planetoid/cave/explored)
"iI" = (
/turf/open/floor/plasteel/dark,
/area/overmap_encounter/planetoid/cave/explored)
"jb" = (
/obj/item/stack/sheet/metal,
/obj/item/stack/sheet/metal,
/turf/open/floor/plating/asteroid/whitesands,
/area/overmap_encounter/planetoid/cave/explored)
"jC" = (
/obj/machinery/atmospherics/components/unary/thermomachine/freezer{
	dir = 8
	},
/turf/open/floor/engine{
	initial_gas_mix = "ws_atmos"
	},
/area/overmap_encounter/planetoid/cave/explored)
"jJ" = (
/obj/machinery/door/airlock/hatch{
	dir = 4
	},
/turf/open/floor/plasteel/dark,
/area/overmap_encounter/planetoid/cave/explored)
"kx" = (
/obj/machinery/atmospherics/pipe/manifold/cyan/visible{
	dir = 8
	},
/turf/open/floor/engine{
	initial_gas_mix = "ws_atmos"
	},
/area/overmap_encounter/planetoid/cave/explored)
"mc" = (
/obj/machinery/atmospherics/pipe/simple/scrubbers{
	dir = 8
	},
/turf/open/floor/engine{
	initial_gas_mix = "ws_atmos"
	},
/area/overmap_encounter/planetoid/cave/explored)
"mX" = (
/obj/effect/turf_decal/industrial/traffic{
	dir = 1
	},
/obj/machinery/atmospherics/pipe/simple/cyan/visible{
	dir = 5
	},
/turf/open/floor/engine{
	initial_gas_mix = "ws_atmos"
	},
/area/overmap_encounter/planetoid/cave/explored)
"nI" = (
/obj/item/stack/cable_coil/cut/blue,
/obj/item/stack/tile/plasteel,
/turf/open/floor/plating/asteroid/whitesands/dried,
/area/overmap_encounter/planetoid/cave/explored)
"nJ" = (
/obj/machinery/power/terminal{
	dir = 1
	},
/turf/open/floor/plating{
	icon_state = "platingdmg1"
	},
/area/overmap_encounter/planetoid/cave/explored)
"nO" = (
/obj/machinery/atmospherics/components/binary/circulator{
	dir = 4
	},
/turf/open/floor/engine{
	initial_gas_mix = "ws_atmos"
	},
/area/overmap_encounter/planetoid/cave/explored)
"pE" = (
/obj/structure/chair/comfy,
/turf/open/floor/plating{
	icon_state = "panelscorched";
	initial_gas_mix = "ws_atmos"
	},
/area/overmap_encounter/planetoid/cave/explored)
"pF" = (
/obj/effect/turf_decal/industrial/traffic{
	dir = 1
	},
/obj/machinery/atmospherics/pipe/simple/scrubbers,
/turf/open/floor/engine{
	initial_gas_mix = "ws_atmos"
	},
/area/overmap_encounter/planetoid/cave/explored)
"qd" = (
/obj/machinery/door/airlock/engineering,
/turf/open/floor/plating{
	initial_gas_mix = "ws_atmos"
	},
/area/overmap_encounter/planetoid/cave/explored)
"qT" = (
/obj/item/clothing/gloves/combat,
/turf/open/floor/plating/asteroid/whitesands,
/area/overmap_encounter/planetoid/cave/explored)
"qW" = (
/mob/living/simple_animal/hostile/syndicate/ranged/smg/space,
/turf/open/floor/plating{
	icon_state = "platingdmg2";
	initial_gas_mix = "ws_atmos"
	},
/area/overmap_encounter/planetoid/cave/explored)
"rd" = (
/mob/living/simple_animal/hostile/syndicate/ranged/shotgun/space,
/turf/open/floor/plating/asteroid/whitesands,
/area/overmap_encounter/planetoid/cave/explored)
"rF" = (
/obj/effect/turf_decal/industrial/loading/red,
/turf/open/floor/plasteel/dark,
/area/overmap_encounter/planetoid/cave/explored)
"sw" = (
/obj/effect/decal/cleanable/ash/large,
/turf/open/floor/plating{
	icon_state = "panelscorched";
	initial_gas_mix = "ws_atmos"
	},
/area/overmap_encounter/planetoid/cave/explored)
"sD" = (
/mob/living/simple_animal/hostile/syndicate/ranged/smg/space,
/mob/living/simple_animal/hostile/syndicate/ranged/space,
/turf/open/floor/plating{
	icon_state = "platingdmg2";
	initial_gas_mix = "ws_atmos"
	},
/area/overmap_encounter/planetoid/cave/explored)
"tg" = (
/obj/item/stock_parts/cell/empty,
/obj/item/stock_parts/cell/empty{
	pixel_x = -8;
	pixel_y = -7
	},
/obj/item/stock_parts/cell/empty{
	pixel_x = 6;
	pixel_y = -10
	},
/turf/open/floor/plating/asteroid/whitesands,
/area/overmap_encounter/planetoid/cave/explored)
"tk" = (
/obj/machinery/atmospherics/pipe/simple/cyan/visible{
	dir = 9
	},
/turf/open/floor/plating{
	icon_state = "platingdmg1";
	initial_gas_mix = "ws_atmos"
	},
/area/overmap_encounter/planetoid/cave/explored)
"ty" = (
/obj/effect/turf_decal/corner/opaque/yellow{
	dir = 4
	},
/obj/effect/turf_decal/corner/opaque/yellow{
	dir = 1
	},
/turf/open/floor/plasteel/dark,
/area/overmap_encounter/planetoid/cave/explored)
"tI" = (
/turf/open/floor/plating/asteroid/whitesands,
/area/overmap_encounter/planetoid/cave/explored)
"ul" = (
/turf/open/floor/plating/asteroid/whitesands/dried,
/area/overmap_encounter/planetoid/cave/explored)
"uq" = (
/obj/machinery/atmospherics/components/binary/pump,
/turf/open/floor/plating{
	initial_gas_mix = "ws_atmos"
	},
/area/overmap_encounter/planetoid/cave/explored)
"vv" = (
/obj/machinery/atmospherics/pipe/manifold/cyan/visible,
/turf/open/floor/engine{
	initial_gas_mix = "ws_atmos"
	},
/area/overmap_encounter/planetoid/cave/explored)
"vw" = (
/obj/effect/turf_decal/corner/opaque/blue,
/turf/open/floor/plasteel/dark,
/area/overmap_encounter/planetoid/cave/explored)
"vK" = (
/mob/living/simple_animal/hostile/syndicate/ranged/shotgun/space,
/turf/open/floor/plating{
	icon_state = "platingdmg1";
	initial_gas_mix = "ws_atmos"
	},
/area/overmap_encounter/planetoid/cave/explored)
"wt" = (
/obj/structure/frame/machine,
/turf/open/floor/plating{
	initial_gas_mix = "ws_atmos"
	},
/area/overmap_encounter/planetoid/cave/explored)
"wX" = (
/obj/item/storage/firstaid/ancient,
/turf/open/floor/plating/asteroid/whitesands,
/area/overmap_encounter/planetoid/cave/explored)
"xh" = (
/obj/item/storage/toolbox/syndicate,
/turf/open/floor/engine{
	initial_gas_mix = "ws_atmos"
	},
/area/overmap_encounter/planetoid/cave/explored)
"xA" = (
/obj/machinery/atmospherics/pipe/simple/cyan/visible{
	dir = 8
	},
/turf/open/floor/plating{
	initial_gas_mix = "ws_atmos"
	},
/area/overmap_encounter/planetoid/cave/explored)
"xC" = (
/obj/machinery/atmospherics/pipe/simple/scrubbers{
	dir = 8
	},
/turf/open/floor/plating{
	initial_gas_mix = "ws_atmos"
	},
/area/overmap_encounter/planetoid/cave/explored)
"xF" = (
/obj/structure/window/plasma/reinforced/plastitanium/unanchored,
/turf/open/floor/plating{
	icon_state = "platingdmg1"
	},
/area/overmap_encounter/planetoid/cave/explored)
"zd" = (
/obj/machinery/atmospherics/pipe/simple/scrubbers{
	dir = 8
	},
/turf/open/floor/plating/asteroid/whitesands,
/area/overmap_encounter/planetoid/cave/explored)
"zh" = (
/obj/machinery/atmospherics/pipe/manifold/scrubbers/visible{
	dir = 4
	},
/turf/open/floor/engine{
	initial_gas_mix = "ws_atmos"
	},
/area/overmap_encounter/planetoid/cave/explored)
"zn" = (
/obj/item/circuitboard/machine/sleeper,
/turf/open/floor/plating{
	icon_state = "platingdmg1";
	initial_gas_mix = "ws_atmos"
	},
/area/overmap_encounter/planetoid/cave/explored)
"zo" = (
/obj/machinery/atmospherics/pipe/simple/scrubbers,
/turf/open/floor/engine{
	initial_gas_mix = "ws_atmos"
	},
/area/overmap_encounter/planetoid/cave/explored)
"zr" = (
/obj/item/clothing/neck/stethoscope,
/turf/open/floor/plating{
	initial_gas_mix = "ws_atmos"
	},
/area/overmap_encounter/planetoid/cave/explored)
"zU" = (
/obj/machinery/atmospherics/pipe/simple/cyan/visible{
	dir = 8
	},
/turf/open/floor/plating{
	icon_state = "platingdmg1";
	initial_gas_mix = "ws_atmos"
	},
/area/overmap_encounter/planetoid/cave/explored)
"Ag" = (
/obj/effect/turf_decal/industrial/traffic{
	dir = 1
	},
/obj/machinery/atmospherics/pipe/simple/dark/visible{
	dir = 5
	},
/turf/open/floor/engine{
	initial_gas_mix = "ws_atmos"
	},
/area/overmap_encounter/planetoid/cave/explored)
"Ao" = (
/obj/machinery/atmospherics/pipe/simple/cyan/visible,
/turf/open/floor/engine{
	initial_gas_mix = "ws_atmos"
	},
/area/overmap_encounter/planetoid/cave/explored)
"At" = (
/turf/closed/wall/r_wall/syndicate,
/area/overmap_encounter/planetoid/cave/explored)
"Bd" = (
/obj/effect/decal/cleanable/ash,
/obj/effect/decal/cleanable/ash{
	pixel_x = 3;
	pixel_y = -3
	},
/obj/effect/decal/cleanable/ash{
	pixel_x = 2;
	pixel_y = -2
	},
/turf/open/floor/plating{
	icon_state = "panelscorched";
	initial_gas_mix = "ws_atmos"
	},
/area/overmap_encounter/planetoid/cave/explored)
"BH" = (
/obj/structure/frame/machine,
/obj/item/circuitboard/machine/smes,
/obj/item/stock_parts/capacitor,
/obj/item/stack/cable_coil/cut/blue,
/obj/item/stock_parts/cell/empty,
/turf/open/floor/plating{
	icon_state = "platingdmg2"
	},
/area/overmap_encounter/planetoid/cave/explored)
"Cn" = (
/obj/effect/turf_decal/industrial/traffic{
	dir = 1
	},
/obj/machinery/atmospherics/pipe/simple/cyan/visible{
	dir = 8
	},
/turf/open/floor/engine{
	initial_gas_mix = "ws_atmos"
	},
/area/overmap_encounter/planetoid/cave/explored)
"CZ" = (
/turf/open/floor/plating{
	icon_state = "platingdmg1";
	initial_gas_mix = "ws_atmos"
	},
/area/overmap_encounter/planetoid/cave/explored)
"Dh" = (
/turf/open/floor/plating{
	icon_state = "platingdmg2";
	initial_gas_mix = "ws_atmos"
	},
/area/overmap_encounter/planetoid/cave/explored)
"Dp" = (
/obj/machinery/atmospherics/pipe/simple/cyan/visible,
/turf/open/floor/plating{
	icon_state = "platingdmg1";
	initial_gas_mix = "ws_atmos"
	},
/area/overmap_encounter/planetoid/cave/explored)
"ED" = (
/obj/machinery/atmospherics/components/binary/pump{
	dir = 1
	},
/turf/open/floor/plating{
	icon_state = "platingdmg1";
	initial_gas_mix = "ws_atmos"
	},
/area/overmap_encounter/planetoid/cave/explored)
"EZ" = (
/obj/machinery/atmospherics/pipe/simple/dark/visible{
	dir = 10
	},
/turf/open/floor/plating{
	icon_state = "platingdmg1";
	initial_gas_mix = "ws_atmos"
	},
/area/overmap_encounter/planetoid/cave/explored)
"Gy" = (
/obj/machinery/atmospherics/pipe/manifold/dark/visible{
	dir = 4
	},
/turf/open/floor/engine{
	initial_gas_mix = "ws_atmos"
	},
/area/overmap_encounter/planetoid/cave/explored)
"GB" = (
/obj/machinery/atmospherics/components/unary/portables_connector/visible{
	dir = 4
	},
/obj/effect/turf_decal/industrial/outline/yellow,
/turf/open/floor/plasteel/dark,
/area/overmap_encounter/planetoid/cave/explored)
"Hv" = (
/obj/structure/door_assembly/door_assembly_hatch,
/turf/open/floor/plating{
	initial_gas_mix = "ws_atmos"
	},
/area/overmap_encounter/planetoid/cave/explored)
"JR" = (
/turf/open/floor/engine{
	initial_gas_mix = "ws_atmos"
	},
/area/overmap_encounter/planetoid/cave/explored)
"JY" = (
/obj/machinery/atmospherics/components/unary/portables_connector/visible,
/obj/machinery/portable_atmospherics/canister/oxygen,
/turf/open/floor/plating{
	icon_state = "platingdmg1";
	initial_gas_mix = "ws_atmos"
	},
/area/overmap_encounter/planetoid/cave/explored)
"Kh" = (
/obj/machinery/atmospherics/pipe/simple/scrubbers{
	dir = 5
	},
/turf/open/floor/plating{
	icon_state = "platingdmg1";
	initial_gas_mix = "ws_atmos"
	},
/area/overmap_encounter/planetoid/cave/explored)
"Kl" = (
/obj/item/pickaxe/improvised,
/turf/open/floor/plating/asteroid/whitesands,
/area/overmap_encounter/planetoid/cave/explored)
"KM" = (
/turf/open/floor/pod/dark,
/area/overmap_encounter/planetoid/cave/explored)
"LE" = (
/obj/effect/turf_decal/industrial/traffic{
	dir = 1
	},
/obj/machinery/atmospherics/components/binary/pump,
/obj/machinery/atmospherics/pipe/simple/dark/visible{
	dir = 8
	},
/turf/open/floor/engine{
	initial_gas_mix = "ws_atmos"
	},
/area/overmap_encounter/planetoid/cave/explored)
"Ms" = (
/obj/effect/turf_decal/industrial/hatch/yellow,
/obj/machinery/portable_atmospherics/canister/toxins,
/turf/open/floor/plasteel/dark,
/area/overmap_encounter/planetoid/cave/explored)
"MC" = (
/obj/item/clothing/shoes/jackboots,
/turf/open/floor/plating/asteroid/whitesands,
/area/overmap_encounter/planetoid/cave/explored)
"MD" = (
/obj/machinery/atmospherics/pipe/simple/dark/visible{
	dir = 5
	},
/turf/open/floor/plating/asteroid/whitesands{
	dir = 8
	},
/area/overmap_encounter/planetoid/cave/explored)
"Nc" = (
/turf/open/floor/mineral/plastitanium/red{
	initial_gas_mix = "ws_atmos"
	},
/area/overmap_encounter/planetoid/cave/explored)
"Nd" = (
/obj/structure/frame/machine,
/turf/open/floor/engine{
	initial_gas_mix = "ws_atmos"
	},
/area/overmap_encounter/planetoid/cave/explored)
"Nh" = (
/obj/structure/window/plasma/reinforced/plastitanium/unanchored,
/obj/machinery/atmospherics/pipe/simple/scrubbers,
/turf/open/floor/plating{
	icon_state = "platingdmg1"
	},
/area/overmap_encounter/planetoid/cave/explored)
"NF" = (
/obj/effect/turf_decal/corner/opaque/blue{
	dir = 8
	},
/turf/open/floor/plasteel/dark,
/area/overmap_encounter/planetoid/cave/explored)
"NL" = (
/obj/item/toy/plush/lizardplushie{
	desc = "An adorable stuffed toy that resembles nothing like a tegu.";
	name = "tegu plushie"
	},
/turf/open/floor/plating/asteroid/whitesands,
/area/overmap_encounter/planetoid/cave/explored)
"NU" = (
/obj/effect/turf_decal/industrial/traffic{
	dir = 5
	},
/turf/open/floor/engine{
	initial_gas_mix = "ws_atmos"
	},
/area/overmap_encounter/planetoid/cave/explored)
"NX" = (
/obj/machinery/atmospherics/pipe/simple/cyan/visible{
	dir = 10
	},
/turf/open/floor/plating{
	initial_gas_mix = "ws_atmos"
	},
/area/overmap_encounter/planetoid/cave/explored)
"Of" = (
/mob/living/simple_animal/hostile/syndicate/ranged/space,
/turf/open/floor/plating/asteroid/whitesands,
/area/overmap_encounter/planetoid/cave/explored)
"Oi" = (
/mob/living/simple_animal/hostile/syndicate/ranged/space/stormtrooper,
/turf/open/floor/plating{
	icon_state = "panelscorched";
	initial_gas_mix = "ws_atmos"
	},
/area/overmap_encounter/planetoid/cave/explored)
"Ot" = (
/obj/effect/turf_decal/industrial/traffic{
	dir = 4
	},
/turf/open/floor/engine{
	initial_gas_mix = "ws_atmos"
	},
/area/overmap_encounter/planetoid/cave/explored)
"Pm" = (
/obj/machinery/atmospherics/pipe/simple/cyan/visible{
	dir = 6
	},
/turf/open/floor/engine{
	initial_gas_mix = "ws_atmos"
	},
/area/overmap_encounter/planetoid/cave/explored)
"Pq" = (
/obj/item/stack/sheet/metal,
/obj/machinery/atmospherics/components/binary/pump{
	dir = 1
	},
/turf/open/floor/plating/asteroid/whitesands,
/area/overmap_encounter/planetoid/cave/explored)
"PJ" = (
/obj/effect/turf_decal/industrial/traffic{
	dir = 1
	},
/obj/machinery/atmospherics/pipe/simple/dark/visible{
	dir = 8
	},
/turf/open/floor/engine{
	initial_gas_mix = "ws_atmos"
	},
/area/overmap_encounter/planetoid/cave/explored)
"PN" = (
/obj/effect/turf_decal/industrial/traffic{
	dir = 1
	},
/turf/open/floor/engine{
	initial_gas_mix = "ws_atmos"
	},
/area/overmap_encounter/planetoid/cave/explored)
"Qd" = (
/obj/machinery/atmospherics/components/unary/portables_connector/visible,
/obj/machinery/portable_atmospherics/canister/toxins,
/turf/open/floor/plating{
	icon_state = "panelscorched";
	initial_gas_mix = "ws_atmos"
	},
/area/overmap_encounter/planetoid/cave/explored)
"QE" = (
/obj/machinery/atmospherics/pipe/simple/cyan/visible,
/turf/open/floor/plating{
	initial_gas_mix = "ws_atmos"
	},
/area/overmap_encounter/planetoid/cave/explored)
"RJ" = (
/turf/template_noop,
/area/template_noop)
"RR" = (
/obj/machinery/atmospherics/components/binary/pump,
/turf/open/floor/engine{
	initial_gas_mix = "ws_atmos"
	},
/area/overmap_encounter/planetoid/cave/explored)
"RW" = (
/obj/machinery/atmospherics/pipe/simple/scrubbers{
	dir = 10
	},
/turf/open/floor/engine{
	initial_gas_mix = "ws_atmos"
	},
/area/overmap_encounter/planetoid/cave/explored)
"Sc" = (
/obj/effect/turf_decal/industrial/traffic{
	dir = 4
	},
/mob/living/simple_animal/hostile/syndicate/ranged/smg/space,
/turf/open/floor/engine{
	initial_gas_mix = "ws_atmos"
	},
/area/overmap_encounter/planetoid/cave/explored)
"SG" = (
/obj/effect/decal/remains/human,
/obj/effect/decal/cleanable/blood/old,
/obj/item/clothing/under/syndicate{
	pixel_y = -11
	},
/turf/open/floor/plating/asteroid/whitesands,
/area/overmap_encounter/planetoid/cave/explored)
"SO" = (
/obj/machinery/atmospherics/pipe/simple/dark/visible,
/turf/closed/wall/r_wall/syndicate,
/area/overmap_encounter/planetoid/cave/explored)
"Ta" = (
/obj/machinery/atmospherics/pipe/simple/scrubbers,
/turf/open/floor/plating{
	icon_state = "panelscorched";
	initial_gas_mix = "ws_atmos"
	},
/area/overmap_encounter/planetoid/cave/explored)
"Tw" = (
/obj/item/clothing/head/hardhat/red{
	desc = "A piece of headgear used in dangerous working conditions to protect the head. On closer inspection it apears to be a regular hardhat painted red.";
	name = "syndicate hardhat"
	},
/obj/machinery/atmospherics/components/unary/portables_connector/visible{
	dir = 8
	},
/turf/open/floor/plating{
	icon_state = "panelscorched";
	initial_gas_mix = "ws_atmos"
	},
/area/overmap_encounter/planetoid/cave/explored)
"Tz" = (
/obj/item/stack/tile/plasteel,
/mob/living/simple_animal/hostile/syndicate/ranged/space,
/turf/open/floor/plating/asteroid/whitesands/dried,
/area/overmap_encounter/planetoid/cave/explored)
"TC" = (
/obj/machinery/atmospherics/components/binary/pump{
	dir = 4
	},
/turf/open/floor/plating{
	icon_state = "panelscorched";
	initial_gas_mix = "ws_atmos"
	},
/area/overmap_encounter/planetoid/cave/explored)
"TN" = (
/obj/effect/turf_decal/industrial/outline/yellow,
/obj/machinery/portable_atmospherics/canister/toxins,
/obj/machinery/atmospherics/components/unary/portables_connector/visible{
	dir = 4
	},
/turf/open/floor/plasteel/dark,
/area/overmap_encounter/planetoid/cave/explored)
"TU" = (
/obj/structure/frame/machine,
/obj/item/stack/cable_coil/cut/blue,
/turf/open/floor/engine{
	initial_gas_mix = "ws_atmos"
	},
/area/overmap_encounter/planetoid/cave/explored)
"TX" = (
/turf/open/floor/plating{
	initial_gas_mix = "ws_atmos"
	},
/area/overmap_encounter/planetoid/cave/explored)
"Ub" = (
/obj/item/gun/ballistic/automatic/pistol{
	spawnwithmagazine = 0
	},
/turf/open/floor/plating/asteroid/whitesands,
/area/overmap_encounter/planetoid/cave/explored)
"Un" = (
/turf/open/floor/plating,
/area/overmap_encounter/planetoid/cave/explored)
"UJ" = (
/obj/effect/decal/cleanable/ash,
/obj/item/paper{
	desc = null;
	info = "Well, we failed. The undoable has been done. We were taken out. The great Starfury is stuck in orbit, and many of our systems are damaged. There is no other choice but to evacuate. However, me and a group of talented indviduals will go with me. I will activate the hyperdrive, one last time to scuttle the ship before Nanotrasen can get their grubby little hands on it, on the planet of our greatest victory.  If you are worried about me, I have my tegu plushie and all i need to survive for a year. Men and women, its been a honour.";
	name = "Starfury Status Report - January 15th, 2501"
	},
/turf/open/floor/plating{
	icon_state = "panelscorched";
	initial_gas_mix = "ws_atmos"
	},
/area/overmap_encounter/planetoid/cave/explored)
"UX" = (
/obj/item/stack/sheet/metal,
/turf/open/floor/plating/asteroid/whitesands,
/area/overmap_encounter/planetoid/cave/explored)
"Va" = (
/obj/machinery/atmospherics/components/binary/circulator/cold{
	dir = 8
	},
/turf/open/floor/engine{
	initial_gas_mix = "ws_atmos"
	},
/area/overmap_encounter/planetoid/cave/explored)
"Vo" = (
/obj/effect/turf_decal/industrial/traffic{
	dir = 8
	},
/turf/open/floor/engine{
	initial_gas_mix = "ws_atmos"
	},
/area/overmap_encounter/planetoid/cave/explored)
"Wp" = (
/obj/machinery/power/smes,
/turf/open/floor/plating{
	icon_state = "platingdmg2"
	},
/area/overmap_encounter/planetoid/cave/explored)
"Wu" = (
/obj/effect/turf_decal/industrial/outline/yellow,
/obj/machinery/portable_atmospherics/canister/toxins,
/obj/machinery/atmospherics/components/unary/portables_connector/visible{
	dir = 8
	},
/turf/open/floor/plasteel/dark,
/area/overmap_encounter/planetoid/cave/explored)
"Xm" = (
/obj/machinery/atmospherics/pipe/simple/cyan/visible,
/obj/item/pipe_dispenser,
/turf/open/floor/plating{
	icon_state = "panelscorched";
	initial_gas_mix = "ws_atmos"
	},
/area/overmap_encounter/planetoid/cave/explored)
"XH" = (
/turf/closed/mineral/random/whitesands,
/area/overmap_encounter/planetoid/cave/explored)
"Yd" = (
/obj/machinery/portable_atmospherics/canister/toxins,
/turf/open/floor/plating{
	icon_state = "panelscorched";
	initial_gas_mix = "ws_atmos"
	},
/area/overmap_encounter/planetoid/cave/explored)
"YU" = (
/obj/item/stack/sheet/metal,
/turf/open/floor/engine{
	initial_gas_mix = "ws_atmos"
	},
/area/overmap_encounter/planetoid/cave/explored)
"Zj" = (
/obj/item/stock_parts/cell/empty{
	pixel_x = 5;
	pixel_y = -6
	},
/obj/machinery/power/terminal{
	dir = 1
	},
/turf/open/floor/plating/asteroid/whitesands/dried,
/area/overmap_encounter/planetoid/cave/explored)

(1,1,1) = {"
RJ
RJ
RJ
XH
XH
XH
XH
XH
XH
XH
XH
XH
gP
Zj
XH
XH
XH
RJ
XH
XH
XH
XH
XH
RJ
RJ
"}
(2,1,1) = {"
RJ
RJ
XH
XH
XH
XH
XH
XH
XH
XH
XH
At
BH
tg
Tz
dW
XH
RJ
At
At
At
At
XH
XH
RJ
"}
(3,1,1) = {"
RJ
RJ
XH
XH
XH
XH
tI
CZ
At
XH
XH
At
Wp
nJ
nI
XH
At
xF
At
tI
tI
tI
XH
XH
RJ
"}
(4,1,1) = {"
RJ
XH
XH
XH
XH
tI
TX
tI
At
At
At
At
At
At
ir
At
At
CZ
tI
ab
Of
tI
XH
XH
XH
"}
(5,1,1) = {"
RJ
XH
XH
XH
XH
ab
ab
vK
iI
fv
rF
qd
ab
tI
ab
tI
ab
em
Vo
Qd
MD
Dh
XH
XH
XH
"}
(6,1,1) = {"
RJ
XH
XH
XH
XH
XH
Dh
tI
ab
fv
rF
qd
PN
YU
rd
CZ
JR
ab
CZ
JY
Gy
Ag
XH
XH
XH
"}
(7,1,1) = {"
XH
XH
At
XH
At
At
iI
tI
At
At
At
At
NU
ff
zo
aA
zo
zo
zo
dA
Kh
PJ
XH
XH
XH
"}
(8,1,1) = {"
XH
XH
XH
wX
zn
At
tI
TX
At
ab
sw
At
At
zd
CZ
jb
ab
Yd
CZ
JR
mc
eH
At
XH
XH
"}
(9,1,1) = {"
XH
At
At
Dh
tI
At
gw
vw
At
pE
UJ
At
At
dk
dU
ab
CZ
TN
GB
CZ
bc
LE
XH
XH
XH
"}
(10,1,1) = {"
XH
XH
XH
tI
qW
Hv
ty
dt
fP
Oi
Bd
At
At
xC
TX
TX
tI
af
fq
JR
TC
EZ
SO
XH
XH
"}
(11,1,1) = {"
XH
XH
XH
zr
TX
At
Dh
NF
At
ab
ab
At
At
RW
zo
Pq
nO
ED
zh
Ta
fh
pF
Nh
XH
XH
"}
(12,1,1) = {"
RJ
XH
XH
XH
wt
At
iI
iI
At
cF
cn
At
At
ab
JR
JR
TU
JR
TX
JR
JR
JR
xF
XH
XH
"}
(13,1,1) = {"
RJ
XH
XH
At
At
At
jJ
jJ
At
At
At
At
At
Pm
Dp
RR
Va
uq
do
Xm
QE
mX
xF
XH
XH
"}
(14,1,1) = {"
RJ
XH
XH
XH
XH
XH
ab
CZ
hg
cM
cK
At
At
xA
TX
gY
JR
Pm
vv
JR
ab
zU
At
XH
XH
"}
(15,1,1) = {"
RJ
XH
XH
XH
XH
XH
tI
tI
CZ
sD
KM
At
At
fE
UX
tI
xh
Wu
Tw
JR
CZ
Cn
XH
XH
XH
"}
(16,1,1) = {"
RJ
XH
XH
XH
XH
XH
tI
tI
Nc
Dh
Un
At
At
xA
UX
CZ
JR
CZ
Ms
ab
CZ
zU
At
XH
XH
"}
(17,1,1) = {"
RJ
RJ
XH
XH
XH
XH
tI
tI
tI
tI
tI
At
XH
NX
QE
QE
Ao
kx
kx
kx
do
tk
tI
XH
XH
"}
(18,1,1) = {"
RJ
RJ
XH
XH
XH
tI
Ub
tI
tI
tI
tI
XH
XH
XH
XH
XH
XH
jC
Nd
Nd
Nd
PN
tI
XH
XH
"}
(19,1,1) = {"
RJ
RJ
XH
XH
tI
tI
SG
MC
tI
tI
XH
XH
XH
XH
XH
XH
XH
Ot
Sc
Ot
Ot
ul
XH
XH
XH
"}
(20,1,1) = {"
RJ
XH
XH
tI
tI
Kl
qT
tI
tI
XH
XH
RJ
RJ
RJ
XH
XH
XH
iI
cL
ul
ul
XH
XH
XH
XH
"}
(21,1,1) = {"
RJ
XH
XH
NL
tI
tI
XH
XH
XH
XH
RJ
RJ
RJ
RJ
RJ
XH
XH
At
At
iI
iI
iI
XH
XH
RJ
"}
(22,1,1) = {"
RJ
XH
XH
XH
XH
XH
XH
XH
RJ
RJ
RJ
RJ
RJ
RJ
RJ
RJ
XH
XH
At
xF
At
XH
XH
RJ
RJ
"}
(23,1,1) = {"
RJ
RJ
XH
XH
XH
XH
RJ
RJ
RJ
RJ
RJ
RJ
RJ
RJ
RJ
RJ
RJ
RJ
RJ
RJ
RJ
RJ
RJ
RJ
RJ
"}
