//MAP CONVERTED BY dmm2tgm.py THIS HEADER COMMENT PREVENTS RECONVERSION, DO NOT REMOVE
"aa" = (
/obj/structure/barricade/sandbags,
/turf/open/floor/plating/asteroid/whitesands/dried/lit,
/area/overmap_encounter/planetoid/sand/explored)
"ab" = (
/obj/item/reagent_containers/food/drinks/waterbottle/large{
	pixel_x = -8;
	pixel_y = 2
	},
/obj/item/reagent_containers/food/snacks/canned/beans{
	pixel_x = 6;
	pixel_y = 1
	},
/turf/open/floor/mineral/plastitanium/red,
/area/ruin)
"ac" = (
/obj/structure/chair/comfy/shuttle{
	dir = 4
	},
/obj/effect/decal/cleanable/dirt/dust,
/turf/open/floor/mineral/plastitanium/red,
/area/whitesands/surface/outdoors)
"ad" = (
/obj/item/ammo_casing/spent,
/turf/closed/wall/mineral/plastitanium,
/area/whitesands/surface/outdoors)
"ae" = (
/obj/structure/barricade/wooden,
/obj/machinery/door/airlock/centcom{
	aiControlDisabled = 1;
	name = "Assault Pod";
	req_access_txt = "150"
	},
/turf/open/floor/plating,
/area/whitesands/surface/outdoors)
"af" = (
/mob/living/simple_animal/hostile/asteroid/goliath/beast,
/turf/open/floor/mineral/plastitanium/red,
/area/whitesands/surface/outdoors)
"ag" = (
/turf/closed/wall/mineral/plastitanium,
/area/ruin)
"ah" = (
/turf/closed/wall/mineral/plastitanium,
/area/whitesands/surface/outdoors)
"ai" = (
/obj/item/ammo_casing/c10mm{
	pixel_x = -1
	},
/obj/item/ammo_casing/c10mm{
	pixel_x = 7;
	pixel_y = -7
	},
/obj/item/ammo_casing/c10mm{
	pixel_x = -2;
	pixel_y = -10
	},
/obj/item/ammo_casing/c10mm{
	pixel_x = -6;
	pixel_y = -5
	},
/obj/item/ammo_casing/c10mm{
	pixel_x = -6;
	pixel_y = 4
	},
/turf/open/floor/plating/asteroid/whitesands/dried/lit,
/area/whitesands/surface/outdoors)
"aj" = (
/obj/effect/decal/cleanable/blood/gibs,
/turf/open/floor/plating/asteroid/whitesands/dried/lit,
/area/whitesands/surface/outdoors)
"ak" = (
/obj/structure/chair/comfy/shuttle{
	dir = 4
	},
/turf/closed/mineral/random/whitesands,
/area/whitesands/surface/outdoors)
"al" = (
/obj/effect/decal/cleanable/blood/splatter,
/turf/open/floor/mineral/plastitanium/red,
/area/whitesands/surface/outdoors)
"am" = (
/mob/living/simple_animal/hostile/asteroid/goliath/beast{
	dir = 4
	},
/turf/open/floor/plating/asteroid/whitesands/dried/lit,
/area/overmap_encounter/planetoid/sand/explored)
"an" = (
/obj/effect/decal/cleanable/dirt/dust,
/turf/open/floor/mineral/plastitanium/red,
/area/ruin)
"ao" = (
/obj/item/ammo_casing/spent,
/obj/item/ammo_casing/spent{
	dir = 5;
	pixel_x = -8;
	pixel_y = 4
	},
/obj/item/ammo_casing/spent{
	dir = 1;
	pixel_x = 7;
	pixel_y = 4
	},
/turf/open/floor/plating/asteroid/whitesands/lit,
/area/whitesands/surface/outdoors)
"ap" = (
/obj/effect/decal/cleanable/dirt/dust,
/turf/open/floor/mineral/plastitanium/red,
/area/whitesands/surface/outdoors)
"aq" = (
/obj/structure/chair/comfy/shuttle{
	dir = 4
	},
/turf/open/floor/mineral/plastitanium/red,
/area/whitesands/surface/outdoors)
"ar" = (
/obj/effect/decal/cleanable/blood/gibs/core,
/obj/effect/decal/cleanable/dirt/dust,
/turf/open/floor/mineral/plastitanium/red,
/area/whitesands/surface/outdoors)
"as" = (
/obj/item/ammo_casing/spent,
/turf/closed/wall/mineral/plastitanium,
/area/ruin)
"at" = (
/obj/machinery/door/airlock/centcom{
	aiControlDisabled = 1;
	name = "Assault Pod";
	req_access_txt = "150"
	},
/obj/item/ammo_casing/spent,
/turf/closed/mineral/random/whitesands,
/area/whitesands/surface/outdoors)
"au" = (
/obj/item/reagent_containers/food/drinks/waterbottle/large{
	pixel_x = -8;
	pixel_y = 2
	},
/obj/item/reagent_containers/food/snacks/canned/beans{
	pixel_x = 6;
	pixel_y = 1
	},
/turf/open/floor/mineral/plastitanium/red,
/area/whitesands/surface/outdoors)
"av" = (
/obj/item/ammo_casing/spent,
/turf/closed/mineral/random/whitesands,
/area/whitesands/surface/outdoors)
"aw" = (
/turf/open/floor/mineral/plastitanium/red,
/area/whitesands/surface/outdoors)
"ax" = (
/obj/structure/closet/crate/secure/weapon,
/obj/item/gun/ballistic/automatic/ebr,
/obj/item/ammo_box/magazine/ebr,
/obj/effect/decal/cleanable/dirt/dust,
/turf/open/floor/mineral/plastitanium/red,
/area/ruin)
"ay" = (
/turf/open/floor/mineral/plastitanium/red,
/area/ruin)
"az" = (
/obj/structure/barricade/sandbags,
/turf/open/floor/plating/asteroid/whitesands/lit,
/area/whitesands/surface/outdoors)
"aA" = (
/obj/effect/decal/cleanable/blood{
	icon_state = "floor7"
	},
/turf/open/floor/plating/asteroid/whitesands/dried/lit,
/area/whitesands/surface/outdoors)
"aB" = (
/turf/open/floor/plating/asteroid/whitesands/lit,
/area/whitesands/surface/outdoors)
"aC" = (
/obj/effect/decal/cleanable/blood/gibs,
/turf/open/floor/plating/asteroid/whitesands/dried/lit,
/area/overmap_encounter/planetoid/sand/explored)
"aD" = (
/obj/machinery/light/broken{
	dir = 1
	},
/obj/effect/decal/cleanable/dirt/dust,
/turf/open/floor/mineral/plastitanium/red,
/area/whitesands/surface/outdoors)
"aE" = (
/turf/open/floor/plating/asteroid/whitesands/dried/lit,
/area/whitesands/surface/outdoors)
"aF" = (
/obj/effect/decal/cleanable/blood/gibs/up,
/obj/effect/decal/cleanable/blood,
/obj/item/clothing/under/syndicate/intern{
	pixel_x = 1;
	pixel_y = -6
	},
/turf/open/floor/mineral/plastitanium/red,
/area/whitesands/surface/outdoors)
"aG" = (
/obj/effect/decal/cleanable/blood/gibs/core,
/obj/effect/decal/cleanable/dirt/dust,
/turf/open/floor/mineral/plastitanium/red,
/area/ruin)
"aH" = (
/obj/structure/chair/comfy/shuttle{
	dir = 8
	},
/obj/effect/decal/cleanable/dirt/dust,
/turf/open/floor/mineral/plastitanium/red,
/area/whitesands/surface/outdoors)
"aI" = (
/obj/structure/barricade/wooden,
/obj/machinery/door/airlock/centcom{
	aiControlDisabled = 1;
	name = "Assault Pod";
	req_access_txt = "150"
	},
/turf/open/floor/plating,
/area/ruin)
"aJ" = (
/obj/structure/bed,
/obj/effect/decal/cleanable/blood{
	icon_state = "floor2"
	},
/turf/open/floor/mineral/plastitanium/red,
/area/whitesands/surface/outdoors)
"aK" = (
/mob/living/simple_animal/hostile/asteroid/goliath/beast{
	dir = 4
	},
/turf/open/floor/plating/asteroid/whitesands/dried/lit,
/area/whitesands/surface/outdoors)
"aL" = (
/obj/machinery/light,
/turf/open/floor/mineral/plastitanium/red,
/area/whitesands/surface/outdoors)
"aM" = (
/obj/machinery/light/broken/directional/north,
/obj/effect/decal/cleanable/dirt/dust,
/turf/open/floor/mineral/plastitanium/red,
/area/ruin)
"aN" = (
/turf/open/floor/plating/asteroid/whitesands/dried/lit,
/area/overmap_encounter/planetoid/sand/explored)
"aO" = (
/turf/template_noop,
/area/template_noop)
"aP" = (
/obj/structure/closet/crate/secure/weapon,
/obj/item/gun/ballistic/automatic/ebr,
/obj/item/ammo_box/magazine/ebr,
/obj/effect/decal/cleanable/dirt/dust,
/turf/open/floor/mineral/plastitanium/red,
/area/whitesands/surface/outdoors)
"aQ" = (
/turf/open/floor/plating/asteroid/whitesands/lit,
/area/overmap_encounter/planetoid/sand/explored)
"aR" = (
/obj/machinery/door/airlock/centcom{
	name = "Assault Pod";
	req_access_txt = "150"
	},
/turf/open/floor/plating,
/area/whitesands/surface/outdoors)
"aS" = (
/obj/effect/decal/cleanable/blood,
/obj/effect/mob_spawn/human/corpse/syndicatesoldier,
/turf/open/floor/plating/asteroid/whitesands/lit,
/area/whitesands/surface/outdoors)
"aT" = (
/obj/effect/decal/cleanable/blood/gibs/limb{
	icon_state = "gibarm";
	pixel_x = -14;
	pixel_y = 3
	},
/obj/effect/decal/cleanable/blood{
	icon_state = "floor5";
	pixel_x = -2
	},
/turf/open/floor/plating,
/area/whitesands/surface/outdoors)
"aU" = (
/obj/structure/bed,
/obj/effect/decal/cleanable/blood{
	icon_state = "floor2"
	},
/turf/open/floor/mineral/plastitanium/red,
/area/ruin)
"aV" = (
/turf/closed/mineral/random/whitesands,
/area/whitesands/surface/outdoors)
"aW" = (
/obj/effect/decal/cleanable/blood/splatter,
/turf/open/floor/mineral/plastitanium/red,
/area/ruin)
"aX" = (
/obj/item/ammo_casing/spent{
	dir = 1;
	pixel_x = -3;
	pixel_y = -2
	},
/obj/item/ammo_casing/spent{
	dir = 9;
	pixel_x = 7;
	pixel_y = 7
	},
/mob/living/simple_animal/hostile/asteroid/goliath/beast{
	dir = 8
	},
/turf/open/floor/plating/asteroid/whitesands/lit,
/area/whitesands/surface/outdoors)
"aY" = (
/obj/structure/barricade/sandbags,
/turf/open/floor/plating/asteroid/whitesands/dried/lit,
/area/whitesands/surface/outdoors)
"aZ" = (
/mob/living/simple_animal/hostile/asteroid/goliath/beast{
	dir = 8
	},
/turf/open/floor/plating/asteroid/whitesands/lit,
/area/whitesands/surface/outdoors)
"ik" = (
/mob/living/simple_animal/hostile/asteroid/goliath/beast{
	dir = 8
	},
/turf/open/floor/plating/asteroid/whitesands/lit,
/area/overmap_encounter/planetoid/sand/explored)
"is" = (
/obj/structure/chair/comfy/shuttle{
	dir = 4
	},
/turf/closed/mineral/random/whitesands,
/area/overmap_encounter/planetoid/sand/explored)
"kI" = (
/obj/item/ammo_casing/spent,
/obj/item/ammo_casing/spent{
	dir = 5;
	pixel_x = -8;
	pixel_y = 4
	},
/obj/item/ammo_casing/spent{
	dir = 1;
	pixel_x = 7;
	pixel_y = 4
	},
/turf/open/floor/plating/asteroid/whitesands/lit,
/area/overmap_encounter/planetoid/sand/explored)
"lB" = (
/obj/effect/decal/cleanable/blood/gibs/limb{
	icon_state = "gibarm";
	pixel_x = -14;
	pixel_y = 3
	},
/obj/effect/decal/cleanable/blood{
	icon_state = "floor5";
	pixel_x = -2
	},
/turf/open/floor/plating,
/area/ruin)
"te" = (
/obj/structure/chair/comfy/shuttle{
	dir = 4
	},
/obj/effect/decal/cleanable/dirt/dust,
/turf/open/floor/mineral/plastitanium/red,
/area/ruin)
"tq" = (
/obj/item/ammo_casing/spent{
	dir = 1;
	pixel_x = -3;
	pixel_y = -2
	},
/obj/item/ammo_casing/spent{
	dir = 9;
	pixel_x = 7;
	pixel_y = 7
	},
/mob/living/simple_animal/hostile/asteroid/goliath/beast{
	dir = 8
	},
/turf/open/floor/plating/asteroid/whitesands/lit,
/area/overmap_encounter/planetoid/sand/explored)
"um" = (
/obj/machinery/door/airlock/centcom{
	name = "Assault Pod";
	req_access_txt = "150"
	},
/turf/open/floor/plating,
/area/ruin)
"xo" = (
/obj/item/ammo_casing/spent,
/turf/closed/mineral/random/whitesands,
/area/overmap_encounter/planetoid/sand/explored)
"xP" = (
/mob/living/simple_animal/hostile/asteroid/goliath/beast,
/turf/open/floor/mineral/plastitanium/red,
/area/ruin)
"AN" = (
/obj/effect/decal/cleanable/blood,
/obj/effect/mob_spawn/human/corpse/syndicatesoldier,
/turf/open/floor/plating/asteroid/whitesands/lit,
/area/overmap_encounter/planetoid/sand/explored)
"DK" = (
/obj/effect/decal/cleanable/blood{
	icon_state = "floor7"
	},
/turf/open/floor/plating/asteroid/whitesands/dried/lit,
/area/overmap_encounter/planetoid/sand/explored)
"Pb" = (
/obj/machinery/door/airlock/centcom{
	aiControlDisabled = 1;
	name = "Assault Pod";
	req_access_txt = "150";
	dir = 4
	},
/obj/item/ammo_casing/spent,
/turf/open/space/basic,
/area/ruin)
"Pr" = (
/turf/closed/mineral/random/whitesands,
/area/overmap_encounter/planetoid/sand/explored)
"PW" = (
/obj/structure/barricade/sandbags,
/turf/open/floor/plating/asteroid/whitesands/lit,
/area/overmap_encounter/planetoid/sand/explored)
"Qr" = (
/obj/structure/chair/comfy/shuttle{
	dir = 8
	},
/obj/effect/decal/cleanable/dirt/dust,
/turf/open/floor/mineral/plastitanium/red,
/area/ruin)
"Qw" = (
/obj/effect/decal/cleanable/blood/gibs/up,
/obj/effect/decal/cleanable/blood,
/obj/item/clothing/under/syndicate/intern{
	pixel_x = 1;
	pixel_y = -6
	},
/turf/open/floor/mineral/plastitanium/red,
/area/ruin)
"UG" = (
/obj/structure/chair/comfy/shuttle{
	dir = 4
	},
/turf/open/floor/mineral/plastitanium/red,
/area/ruin)
"Xs" = (
/obj/item/ammo_casing/c10mm{
	pixel_x = -1
	},
/obj/item/ammo_casing/c10mm{
	pixel_x = 7;
	pixel_y = -7
	},
/obj/item/ammo_casing/c10mm{
	pixel_x = -2;
	pixel_y = -10
	},
/obj/item/ammo_casing/c10mm{
	pixel_x = -6;
	pixel_y = -5
	},
/obj/item/ammo_casing/c10mm{
	pixel_x = -6;
	pixel_y = 4
	},
/turf/open/floor/plating/asteroid/whitesands/dried/lit,
/area/overmap_encounter/planetoid/sand/explored)
"YU" = (
/obj/machinery/light/directional/south,
/turf/open/floor/mineral/plastitanium/red,
/area/ruin)

(1,1,1) = {"
aO
aO
aO
Pr
xo
xo
xo
Pb
as
ag
aQ
"}
(2,1,1) = {"
aO
aO
PW
AN
ag
Pr
is
an
ab
ag
ag
"}
(3,1,1) = {"
aO
aO
PW
tq
ag
te
Qw
xP
aG
ax
ag
"}
(4,1,1) = {"
aO
aO
PW
aQ
um
an
YU
ag
aM
an
aI
"}
(5,1,1) = {"
aO
aO
aQ
kI
ag
Qr
an
UG
ay
aU
ag
"}
(6,1,1) = {"
aO
aO
aQ
PW
ag
ag
Qr
an
aW
ag
ag
"}
(7,1,1) = {"
aO
aQ
aQ
aQ
aQ
ag
ag
lB
ag
ag
aN
"}
(8,1,1) = {"
aO
aQ
aQ
aQ
aQ
PW
Xs
aN
aC
aa
aO
"}
(9,1,1) = {"
aO
ik
aQ
aQ
aQ
PW
aa
DK
am
aQ
aO
"}
(10,1,1) = {"
aO
aO
aO
aO
aO
aQ
aQ
aQ
aQ
aO
aO
"}
(11,1,1) = {"
aO
aO
aO
aO
aO
aO
aO
aO
aO
aO
aO
"}
