//MAP CONVERTED BY dmm2tgm.py THIS HEADER COMMENT PREVENTS RECONVERSION, DO NOT REMOVE
"aw" = (
/obj/structure/railing,
/turf/open/floor/plating/grass/beach/lit,
/area/overmap_encounter/planetoid/beachplanet/explored)
"bl" = (
/obj/structure/flora/rock/beach,
/turf/open/floor/plating/asteroid/sand/lit,
/area/overmap_encounter/planetoid/beachplanet/explored)
"bv" = (
/obj/item/toy/plush/lizardplushie{
	name = "Soaks-The-Rays"
	},
/turf/open/floor/carpet/orange{
	light_range = 2
	},
/area/overmap_encounter/planetoid/beachplanet/explored)
"bw" = (
/obj/item/toy/crayon/spraycan{
	pixel_x = -5;
	pixel_y = 6
	},
/obj/item/toy/crayon/spraycan{
	pixel_x = 6;
	pixel_y = 3
	},
/turf/open/floor/concrete{
	light_range = 2
	},
/area/overmap_encounter/planetoid/beachplanet/explored)
"bO" = (
/turf/closed/wall/mineral/sandstone,
/area/ruin/unpowered)
"bT" = (
/turf/open/floor/plating/asteroid/sand/lit{
	icon_state = "sand_dug"
	},
/area/overmap_encounter/planetoid/beachplanet/explored)
"bZ" = (
/obj/structure/fluff/beach_umbrella/science,
/turf/open/floor/plating/asteroid/sand/lit,
/area/overmap_encounter/planetoid/beachplanet/explored)
"cn" = (
/obj/item/melee/roastingstick,
/turf/open/floor/plating/grass/beach/lit,
/area/overmap_encounter/planetoid/beachplanet/explored)
"dz" = (
/obj/structure/chair/plastic{
	dir = 8
	},
/turf/open/floor/plating/grass/beach/lit,
/area/overmap_encounter/planetoid/beachplanet/explored)
"dO" = (
/obj/structure/flora/ausbushes/ppflowers,
/turf/open/floor/plating/grass/beach/lit,
/area/overmap_encounter/planetoid/beachplanet/explored)
"eh" = (
/obj/structure/flora/ausbushes/brflowers,
/turf/open/floor/plating/grass/beach/lit,
/area/overmap_encounter/planetoid/beachplanet/explored)
"fw" = (
/turf/open/floor/plasteel/stairs/old{
	light_range = 2
	},
/area/overmap_encounter/planetoid/beachplanet/explored)
"fx" = (
/obj/structure/window/reinforced{
	dir = 8
	},
/obj/structure/window/reinforced,
/obj/item/storage/firstaid/o2,
/turf/open/floor/wood{
	light_range = 2
	},
/area/overmap_encounter/planetoid/beachplanet/explored)
"fP" = (
/obj/structure/fluff/beach_umbrella/engine,
/turf/open/floor/plating/asteroid/sand/lit,
/area/overmap_encounter/planetoid/beachplanet/explored)
"gt" = (
/obj/item/reagent_containers/food/snacks/kebab/rat/double,
/turf/open/floor/plating/grass/beach/lit,
/area/overmap_encounter/planetoid/beachplanet/explored)
"gH" = (
/obj/item/stack/sheet/sandblock,
/turf/open/floor/plating/asteroid/sand/lit,
/area/overmap_encounter/planetoid/beachplanet/explored)
"hB" = (
/obj/structure/fence{
	icon_state = "door_closed"
	},
/turf/open/floor/plating/grass/beach/lit,
/area/overmap_encounter/planetoid/beachplanet/explored)
"lq" = (
/turf/open/floor/concrete{
	light_range = 2
	},
/area/overmap_encounter/planetoid/beachplanet/explored)
"mh" = (
/obj/item/seeds/cocoapod/vanillapod,
/turf/open/floor/plating/dirt/jungle{
	light_range = 2
	},
/area/overmap_encounter/planetoid/beachplanet/explored)
"mn" = (
/turf/open/floor/plating/asteroid/sand/lit,
/area/overmap_encounter/planetoid/beachplanet/explored)
"mt" = (
/turf/open/floor/wood,
/area/ruin/unpowered)
"mw" = (
/obj/effect/decal/cleanable/crayon{
	icon_state = "carp"
	},
/turf/open/floor/concrete{
	light_range = 2
	},
/area/overmap_encounter/planetoid/beachplanet/explored)
"mI" = (
/obj/structure/toilet{
	dir = 4;
	pixel_y = 3
	},
/obj/structure/sink/kitchen{
	dir = 8;
	pixel_x = 15
	},
/turf/open/floor/wood,
/area/ruin/unpowered)
"mO" = (
/obj/item/storage/cans/sixbeer,
/turf/open/floor/carpet/orange{
	light_range = 2
	},
/area/overmap_encounter/planetoid/beachplanet/explored)
"nq" = (
/obj/item/gun/ballistic/automatic/pistol/m1911/no_mag{
	pixel_x = 13
	},
/obj/item/toy/plush/carpplushie{
	desc = "An adorable stuffed toy that resembles a space carp with a gun.";
	name = "glock-ness monster plushie"
	},
/turf/open/water/beach/deep,
/area/overmap_encounter/planetoid/beachplanet/explored)
"nA" = (
/mob/living/simple_animal/hostile/carp,
/turf/open/floor/plating/grass/beach/lit,
/area/overmap_encounter/planetoid/beachplanet/explored)
"on" = (
/obj/structure/table/wood,
/obj/item/clothing/glasses/sunglasses/garb{
	pixel_y = -5
	},
/obj/item/clothing/glasses/sunglasses/big{
	pixel_y = 9
	},
/turf/open/floor/wood,
/area/ruin/unpowered)
"oK" = (
/obj/structure/fence{
	dir = 10;
	icon_state = "corner"
	},
/turf/open/floor/plating/grass/beach/lit,
/area/overmap_encounter/planetoid/beachplanet/explored)
"oY" = (
/turf/open/floor/plating/grass/beach{
	light_range = 2
	},
/area/overmap_encounter/planetoid/beachplanet/explored)
"pB" = (
/obj/structure/statue/sandstone/assistant,
/turf/open/floor/plating/asteroid/sand/lit,
/area/overmap_encounter/planetoid/beachplanet/explored)
"qt" = (
/obj/structure/railing{
	dir = 4
	},
/turf/open/floor/plating/grass/beach/lit,
/area/overmap_encounter/planetoid/beachplanet/explored)
"qH" = (
/obj/structure/window/reinforced{
	dir = 4
	},
/turf/open/floor/wood{
	light_range = 2
	},
/area/overmap_encounter/planetoid/beachplanet/explored)
"qY" = (
/obj/item/reagent_containers/glass/bucket,
/turf/open/floor/plating/asteroid/sand/lit,
/area/overmap_encounter/planetoid/beachplanet/explored)
"rD" = (
/obj/structure/bed,
/obj/item/bedsheet/dorms,
/turf/open/floor/wood,
/area/ruin/unpowered)
"rZ" = (
/obj/structure/flora/tree/palm,
/turf/open/floor/plating/asteroid/sand/lit,
/area/overmap_encounter/planetoid/beachplanet/explored)
"sz" = (
/obj/item/reagent_containers/spray/cleaner,
/turf/open/floor/concrete{
	light_range = 2
	},
/area/overmap_encounter/planetoid/beachplanet/explored)
"sP" = (
/obj/item/storage/crayons,
/turf/open/floor/concrete{
	light_range = 2
	},
/area/overmap_encounter/planetoid/beachplanet/explored)
"tn" = (
/obj/structure/closet/crate/freezer{
	name = "Cooler"
	},
/obj/item/reagent_containers/food/drinks/ice,
/obj/item/reagent_containers/food/drinks/colocup,
/obj/item/reagent_containers/food/drinks/colocup,
/obj/item/reagent_containers/food/drinks/beer{
	desc = "Beer advertised to be the best in space.";
	name = "Masterbrand Beer"
	},
/obj/item/reagent_containers/food/drinks/beer{
	desc = "Beer advertised to be the best in space.";
	name = "Masterbrand Beer"
	},
/obj/item/reagent_containers/food/drinks/beer{
	desc = "Beer advertised to be the best in space.";
	name = "Masterbrand Beer"
	},
/obj/item/reagent_containers/food/drinks/beer/light,
/obj/item/reagent_containers/food/drinks/beer/light,
/obj/item/reagent_containers/food/drinks/beer/light,
/turf/open/floor/plating/asteroid/sand/lit,
/area/overmap_encounter/planetoid/beachplanet/explored)
"tZ" = (
/obj/structure/flora/ausbushes/leafybush,
/turf/open/floor/plating/grass/beach/lit,
/area/overmap_encounter/planetoid/beachplanet/explored)
"uu" = (
/obj/effect/overlay/palmtree_r,
/turf/open/floor/plating/asteroid/sand/lit,
/area/overmap_encounter/planetoid/beachplanet/explored)
"ve" = (
/obj/structure/flora/junglebush/large,
/turf/open/floor/plating/grass/beach/lit,
/area/overmap_encounter/planetoid/beachplanet/explored)
"vv" = (
/obj/item/reagent_containers/food/drinks/colocup{
	pixel_x = -7;
	pixel_y = -2
	},
/obj/item/reagent_containers/food/drinks/colocup{
	pixel_x = 5;
	pixel_y = 6
	},
/obj/item/reagent_containers/food/drinks/bottle/rum{
	pixel_x = 4;
	pixel_y = -3
	},
/turf/open/floor/carpet/red{
	light_range = 2
	},
/area/overmap_encounter/planetoid/beachplanet/explored)
"wf" = (
/obj/effect/spawner/structure/window/reinforced,
/obj/structure/grille,
/obj/structure/curtain,
/turf/open/floor/wood,
/area/ruin/unpowered)
"wA" = (
/obj/structure/flora/ausbushes/grassybush,
/turf/open/floor/plating/asteroid/sand/lit,
/area/overmap_encounter/planetoid/beachplanet/explored)
"yH" = (
/turf/open/floor/plating/grass/beach/lit,
/area/overmap_encounter/planetoid/beachplanet/explored)
"yJ" = (
/obj/structure/fence{
	dir = 4
	},
/obj/structure/fence{
	dir = 4
	},
/turf/open/floor/plating/grass/beach/lit,
/area/overmap_encounter/planetoid/beachplanet/explored)
"AF" = (
/obj/structure/fence{
	dir = 4
	},
/turf/open/floor/plating/grass/beach/lit,
/area/overmap_encounter/planetoid/beachplanet/explored)
"AK" = (
/obj/structure/chair/plastic{
	dir = 4
	},
/turf/open/floor/plating/grass/beach/lit,
/area/overmap_encounter/planetoid/beachplanet/explored)
"Bx" = (
/obj/item/seeds/cocoapod,
/turf/open/floor/plating/dirt/jungle{
	light_range = 2
	},
/area/overmap_encounter/planetoid/beachplanet/explored)
"BH" = (
/obj/item/toy/beach_ball,
/turf/open/floor/plating/asteroid/sand/lit,
/area/overmap_encounter/planetoid/beachplanet/explored)
"Do" = (
/obj/structure/fluff/beach_umbrella/cap,
/turf/open/floor/plating/asteroid/sand/lit,
/area/overmap_encounter/planetoid/beachplanet/explored)
"DE" = (
/obj/structure/catwalk/over/plated_catwalk,
/turf/open/floor/plating/asteroid/sand/lit,
/area/overmap_encounter/planetoid/beachplanet/explored)
"DI" = (
/obj/item/storage/cans/sixbeer,
/turf/open/floor/plating/grass/beach/lit,
/area/overmap_encounter/planetoid/beachplanet/explored)
"En" = (
/obj/structure/fence,
/turf/open/floor/plating/grass/beach/lit,
/area/overmap_encounter/planetoid/beachplanet/explored)
"FB" = (
/obj/structure/flora/ausbushes/fernybush,
/turf/open/floor/plating/grass/beach/lit,
/area/overmap_encounter/planetoid/beachplanet/explored)
"Ha" = (
/obj/structure/chair/plastic{
	dir = 1
	},
/turf/open/floor/plating/grass/beach/lit,
/area/overmap_encounter/planetoid/beachplanet/explored)
"Hj" = (
/obj/item/shovel/spade,
/turf/open/floor/plating/asteroid/sand/lit,
/area/overmap_encounter/planetoid/beachplanet/explored)
"IC" = (
/obj/structure/fence{
	dir = 5;
	icon_state = "corner"
	},
/turf/open/floor/plating/grass/beach/lit,
/area/overmap_encounter/planetoid/beachplanet/explored)
"ID" = (
/turf/open/floor/plating/dirt/jungle{
	light_range = 2
	},
/area/overmap_encounter/planetoid/beachplanet/explored)
"IE" = (
/turf/open/floor/carpet/purple{
	light_range = 2
	},
/area/overmap_encounter/planetoid/beachplanet/explored)
"IO" = (
/obj/structure/chair/plastic,
/turf/open/floor/plating/grass/beach/lit,
/area/overmap_encounter/planetoid/beachplanet/explored)
"Jg" = (
/obj/structure/fence{
	dir = 9;
	icon_state = "corner"
	},
/turf/open/floor/plating/grass/beach/lit,
/area/overmap_encounter/planetoid/beachplanet/explored)
"Jh" = (
/obj/effect/overlay/palmtree_l,
/turf/open/floor/plating/asteroid/sand/lit,
/area/overmap_encounter/planetoid/beachplanet/explored)
"JV" = (
/obj/structure/fluff/fokoff_sign,
/turf/open/floor/plating/grass/beach/lit,
/area/overmap_encounter/planetoid/beachplanet/explored)
"KM" = (
/turf/template_noop,
/area/template_noop)
"KN" = (
/obj/item/toy/seashell,
/turf/open/floor/plating/asteroid/sand/lit,
/area/overmap_encounter/planetoid/beachplanet/explored)
"Lj" = (
/turf/open/floor/concrete/slab_1{
	light_range = 2
	},
/area/overmap_encounter/planetoid/beachplanet/explored)
"Lk" = (
/obj/structure/barricade/sandbags,
/turf/open/floor/plating/asteroid/sand/lit,
/area/overmap_encounter/planetoid/beachplanet/explored)
"Mx" = (
/turf/open/water/beach/deep,
/area/overmap_encounter/planetoid/beachplanet/explored)
"MI" = (
/obj/machinery/door/airlock/sandstone,
/turf/open/floor/wood,
/area/ruin/unpowered)
"MJ" = (
/obj/item/grown/log/tree,
/obj/item/grown/log/tree,
/obj/item/grown/log/tree,
/turf/open/floor/plating/grass/beach/lit,
/area/overmap_encounter/planetoid/beachplanet/explored)
"MP" = (
/obj/structure/window/reinforced{
	dir = 4
	},
/obj/structure/window/reinforced{
	dir = 1;
	layer = 2.9
	},
/obj/structure/chair/stool,
/obj/item/storage/backpack/duffelbag,
/obj/item/clothing/under/shorts/red,
/obj/item/clothing/glasses/sunglasses,
/turf/open/floor/wood{
	light_range = 2
	},
/area/overmap_encounter/planetoid/beachplanet/explored)
"Nv" = (
/obj/structure/railing{
	dir = 8
	},
/turf/open/floor/plating/grass/beach/lit,
/area/overmap_encounter/planetoid/beachplanet/explored)
"NL" = (
/obj/structure/closet/cabinet,
/obj/item/storage/backpack/duffelbag,
/obj/item/clothing/under/shorts/purple,
/obj/item/clothing/shoes/cookflops{
	desc = "A very fashionable pair of flip flops.";
	name = "flip-flops"
	},
/obj/item/clothing/neck/beads,
/obj/item/clothing/under/color/red,
/obj/item/clothing/under/color/white,
/turf/open/floor/wood,
/area/ruin/unpowered)
"Oa" = (
/obj/item/melee/skateboard/pro,
/turf/open/floor/wood,
/area/ruin/unpowered)
"OG" = (
/obj/structure/bonfire/prelit,
/turf/open/floor/plating/grass/beach/lit,
/area/overmap_encounter/planetoid/beachplanet/explored)
"PX" = (
/obj/structure/flora/ausbushes/sparsegrass,
/turf/open/floor/plating/asteroid/sand/lit,
/area/overmap_encounter/planetoid/beachplanet/explored)
"Qv" = (
/obj/structure/fluff/beach_umbrella/security,
/turf/open/floor/plating/asteroid/sand/lit,
/area/overmap_encounter/planetoid/beachplanet/explored)
"RQ" = (
/obj/item/stack/ore/glass/beach,
/turf/open/floor/plating/asteroid/sand/lit,
/area/overmap_encounter/planetoid/beachplanet/explored)
"RT" = (
/obj/structure/flora/ausbushes/sparsegrass,
/turf/open/floor/plating/grass/beach/lit,
/area/overmap_encounter/planetoid/beachplanet/explored)
"Sw" = (
/obj/effect/overlay/coconut,
/turf/open/floor/plating/asteroid/sand/lit,
/area/overmap_encounter/planetoid/beachplanet/explored)
"SC" = (
/obj/item/instrument/guitar,
/turf/open/floor/carpet/blue{
	light_range = 2
	},
/area/overmap_encounter/planetoid/beachplanet/explored)
"Td" = (
/obj/structure/flora/tree/jungle/small,
/turf/open/floor/plating/grass/beach/lit,
/area/overmap_encounter/planetoid/beachplanet/explored)
"Tm" = (
/turf/open/floor/carpet/blue{
	light_range = 2
	},
/area/overmap_encounter/planetoid/beachplanet/explored)
"Vh" = (
/obj/item/cultivator/rake,
/turf/open/floor/plating/dirt/jungle{
	light_range = 2
	},
/area/overmap_encounter/planetoid/beachplanet/explored)
"Vk" = (
/turf/open/floor/carpet/red{
	light_range = 2
	},
/area/overmap_encounter/planetoid/beachplanet/explored)
"VE" = (
/obj/item/reagent_containers/glass/bucket/wooden,
/turf/open/floor/plating/dirt/jungle{
	light_range = 2
	},
/area/overmap_encounter/planetoid/beachplanet/explored)
"VO" = (
/obj/structure/window/reinforced{
	dir = 1
	},
/obj/structure/window/reinforced{
	dir = 8
	},
/obj/structure/table/wood,
/obj/item/megaphone,
/turf/open/floor/wood{
	light_range = 2
	},
/area/overmap_encounter/planetoid/beachplanet/explored)
"WN" = (
/obj/effect/decal/cleanable/crayon{
	icon_state = "#"
	},
/turf/open/floor/concrete{
	light_range = 2
	},
/area/overmap_encounter/planetoid/beachplanet/explored)
"Xv" = (
/obj/effect/mob_spawn/human/corpse/pirate,
/turf/open/floor/plating/grass/beach/lit,
/area/overmap_encounter/planetoid/beachplanet/explored)
"XC" = (
/obj/item/clothing/suit/space/hardsuit/carp/old,
/turf/open/floor/plating/grass/beach/lit,
/area/overmap_encounter/planetoid/beachplanet/explored)
"XK" = (
/obj/item/toy/beach_ball/holoball/dodgeball,
/obj/item/melee/skateboard/hoverboard,
/turf/open/floor/plating/asteroid/sand/lit,
/area/overmap_encounter/planetoid/beachplanet/explored)
"XM" = (
/obj/item/toy/beach_ball/holoball/dodgeball,
/turf/open/floor/plating/asteroid/sand/lit,
/area/overmap_encounter/planetoid/beachplanet/explored)
"XX" = (
/turf/open/water/beach,
/area/overmap_encounter/planetoid/beachplanet/explored)
"Yb" = (
/obj/structure/table/rolling,
/obj/item/reagent_containers/food/snacks/kebab/fiesta,
/obj/item/reagent_containers/food/snacks/kebab/fiesta{
	pixel_y = 7
	},
/obj/item/reagent_containers/food/snacks/kebab/fiesta{
	pixel_y = 13
	},
/turf/open/floor/plating/grass/beach/lit,
/area/overmap_encounter/planetoid/beachplanet/explored)
"YR" = (
/obj/structure/fence{
	icon_state = "corner"
	},
/turf/open/floor/plating/grass/beach/lit,
/area/overmap_encounter/planetoid/beachplanet/explored)
"YV" = (
/obj/effect/mob_spawn/human/corpse/charredskeleton,
/turf/open/floor/carpet/purple{
	light_range = 2
	},
/area/overmap_encounter/planetoid/beachplanet/explored)
"Zl" = (
/obj/structure/railing{
	dir = 1
	},
/obj/item/melee/roastingstick,
/turf/open/floor/plating/grass/beach/lit,
/area/overmap_encounter/planetoid/beachplanet/explored)
"ZF" = (
/obj/machinery/hydroponics/soil,
/turf/open/floor/plating/dirt/jungle{
	light_range = 2
	},
/area/overmap_encounter/planetoid/beachplanet/explored)
"ZY" = (
/obj/structure/sink/puddle,
/turf/open/floor/plating/dirt/jungle{
	light_range = 2
	},
/area/overmap_encounter/planetoid/beachplanet/explored)

(1,1,1) = {"
KM
KM
KM
KM
KM
KM
yH
yH
yH
yH
yH
yH
oY
yH
yH
yH
yH
yH
yH
KM
KM
KM
KM
KM
KM
KM
KM
KM
KM
KM
"}
(2,1,1) = {"
KM
KM
bO
bO
bO
bO
bO
bO
bO
yH
eh
yH
ZF
ZF
Bx
mh
ZF
ZF
yH
yH
RT
dO
yH
yH
KM
KM
KM
KM
KM
KM
"}
(3,1,1) = {"
KM
KM
bO
NL
mt
Oa
bO
mI
MI
yH
yH
ZF
ID
ID
VE
ZY
ID
ID
ZF
yH
yH
yH
yH
ve
yH
yH
yH
Td
KM
KM
"}
(4,1,1) = {"
KM
bO
bO
mt
mt
bO
bO
bO
bO
yH
yH
yH
ZF
ZF
ID
Vh
ZF
ZF
yH
yH
yH
FB
yH
yH
yH
yH
yH
yH
yH
KM
"}
(5,1,1) = {"
KM
bO
mt
mt
mt
MI
yH
yH
yH
yH
RT
yH
yH
yH
yH
yH
yH
yH
yH
yH
tZ
yH
RT
yH
DI
AK
yH
gt
yH
KM
"}
(6,1,1) = {"
KM
bO
rD
on
rD
bO
yH
eh
yH
tZ
yH
mn
PX
mn
mn
mn
yH
yH
yH
yH
yH
yH
yH
yH
yH
qt
yH
Ha
yH
KM
"}
(7,1,1) = {"
KM
bO
bO
wf
bO
bO
yH
yH
yH
mn
mn
mn
mn
mn
mn
mn
mn
mn
mn
yH
yH
yH
RT
IO
aw
OG
Zl
MJ
yH
KM
"}
(8,1,1) = {"
KM
ve
yH
yH
yH
yH
mn
wA
mn
mn
mn
mn
mn
mn
mn
mn
mn
PX
mn
mn
yH
yH
yH
yH
cn
Nv
yH
Ha
yH
KM
"}
(9,1,1) = {"
yH
yH
yH
yH
mn
mn
mn
mn
mn
mn
Sw
mn
mn
mn
rZ
wA
mn
mn
mn
mn
wA
mn
oY
oY
dz
yH
Yb
yH
yH
KM
"}
(10,1,1) = {"
yH
FB
yH
mn
mn
mn
mn
mn
XK
mn
mn
mn
PX
mn
mn
mn
mn
PX
mn
mn
mn
PX
oY
oY
yH
yH
yH
RT
yH
KM
"}
(11,1,1) = {"
Td
yH
yH
mn
mn
mn
wA
mn
mn
mn
mn
mn
mn
mn
mn
mn
mn
mn
mn
mn
mn
mn
yH
yH
eh
Jg
En
En
oK
yH
"}
(12,1,1) = {"
yH
yH
RT
wA
mn
mn
mn
mn
mn
mn
PX
mn
mn
bl
XX
XX
mn
mn
wA
mn
mn
mn
yH
yH
yH
AF
nA
FB
AF
yH
"}
(13,1,1) = {"
yH
yH
mn
mn
mn
mn
rZ
mn
Qv
mn
mn
mn
mn
XX
XX
XX
XX
mn
mn
bT
RQ
mn
yH
yH
yH
AF
yH
nA
AF
JV
"}
(14,1,1) = {"
ve
yH
mn
mn
mn
mn
mn
mn
vv
Vk
mn
mn
XX
XX
XX
XX
XX
mn
mn
qY
Hj
bT
mn
yH
yH
AF
XC
yH
hB
yH
"}
(15,1,1) = {"
FB
yH
wA
mn
mn
PX
mn
mn
mn
mn
mn
mn
XX
XX
XX
XX
XX
mn
mn
gH
bT
RQ
mn
dO
yH
AF
yH
eh
AF
yH
"}
(16,1,1) = {"
yH
yH
mn
mn
mn
mn
mn
mn
tn
KN
mn
XX
XX
XX
Mx
XX
XX
XX
mn
pB
gH
mn
mn
PX
yH
AF
nA
Xv
yJ
ve
"}
(17,1,1) = {"
yH
yH
wA
mn
mn
rZ
mn
bZ
mn
mn
mn
XX
XX
XX
Mx
Mx
XX
XX
mn
mn
mn
BH
mn
mn
yH
IC
En
En
YR
yH
"}
(18,1,1) = {"
yH
mn
mn
mn
mn
mn
mn
YV
IE
mn
mn
XX
XX
Mx
Mx
Mx
XX
XX
mn
PX
XM
mn
mn
mn
RT
yH
yH
yH
yH
yH
"}
(19,1,1) = {"
PX
mn
mn
mn
wA
mn
mn
BH
mn
mn
mn
XX
XX
Mx
Mx
Mx
XX
XX
mn
mn
mn
mn
XM
mn
yH
tZ
yH
yH
yH
yH
"}
(20,1,1) = {"
mn
mn
rZ
mn
PX
mn
mn
mn
mn
mn
mn
XX
XX
Mx
nq
Mx
XX
XX
mn
mn
mn
mn
mn
mn
yH
yH
yH
yH
yH
yH
"}
(21,1,1) = {"
mn
mn
mn
Sw
mn
mn
mn
Do
mn
mn
mn
XX
XX
Mx
Mx
Mx
XX
XX
mn
mn
Lk
Lk
Lk
mn
yH
yH
Td
yH
FB
yH
"}
(22,1,1) = {"
KM
mn
mn
mn
mn
mn
mn
Tm
SC
mn
mn
XX
XX
XX
Mx
Mx
XX
XX
mn
mn
mn
mn
mn
mn
Lj
Lj
Lj
Lj
Lj
KM
"}
(23,1,1) = {"
KM
wA
mn
mn
mn
mn
PX
mn
mn
mn
wA
mn
XX
XX
Mx
XX
XX
XX
mn
mn
XM
mn
mn
mn
Lj
sP
lq
WN
Lj
KM
"}
(24,1,1) = {"
KM
mn
mn
mn
fP
mn
mn
mn
mn
mn
mn
mn
XX
XX
XX
XX
XX
XX
mn
mn
mn
wA
mn
mn
Lj
lq
lq
lq
Lj
KM
"}
(25,1,1) = {"
KM
mn
mn
Jh
bv
mn
mn
VO
fx
DE
mn
mn
XX
XX
XX
XX
XX
bl
mn
mn
mn
mn
mn
mn
Lj
bw
mw
sz
Lj
KM
"}
(26,1,1) = {"
KM
mn
mn
uu
mO
mn
mn
MP
qH
fw
mn
mn
bl
XX
XX
XX
mn
mn
mn
rZ
Sw
mn
mn
yH
Lj
Lj
Lj
Lj
Lj
KM
"}
(27,1,1) = {"
KM
mn
mn
mn
PX
mn
mn
mn
mn
mn
mn
mn
mn
mn
mn
mn
mn
PX
mn
mn
mn
mn
mn
yH
eh
yH
yH
yH
KM
KM
"}
(28,1,1) = {"
KM
KM
mn
mn
mn
mn
mn
mn
PX
mn
mn
mn
mn
PX
mn
mn
mn
mn
mn
mn
mn
mn
yH
yH
yH
yH
yH
ve
KM
KM
"}
(29,1,1) = {"
KM
KM
KM
KM
KM
mn
wA
mn
mn
mn
mn
mn
mn
mn
mn
mn
mn
wA
mn
mn
mn
PX
yH
yH
yH
yH
yH
KM
KM
KM
"}
(30,1,1) = {"
KM
KM
KM
KM
KM
KM
KM
KM
mn
mn
mn
mn
wA
mn
mn
mn
mn
mn
mn
mn
yH
yH
yH
RT
KM
KM
KM
KM
KM
KM
"}
