//MAP CONVERTED BY dmm2tgm.py THIS HEADER COMMENT PREVENTS RECONVERSION, DO NOT REMOVE
"bA" = (
/obj/machinery/computer/telecomms/monitor,
/turf/open/floor/mineral/plastitanium/red{
	name = "base floor"
	},
/area/ruin/unpowered/syndicate_outpost)
"cO" = (
/obj/structure/chair/comfy/black{
	desc = "It looks like it hasn't been used in a long time.";
	dir = 1
	},
/turf/open/floor/carpet/black,
/area/ruin/unpowered/syndicate_outpost)
"eF" = (
/obj/machinery/computer/telecomms{
	dir = 8
	},
/turf/open/floor/mineral/plastitanium/red{
	name = "base floor"
	},
/area/ruin/unpowered/syndicate_outpost)
"fa" = (
/obj/machinery/door/window/survival_pod{
	dir = 1
	},
/turf/open/floor/mineral/plastitanium/airless{
	name = "telecomms floor"
	},
/area/ruin/unpowered/syndicate_outpost)
"fZ" = (
/obj/structure/table/reinforced,
/obj/item/radio/intercom/wideband/directional/north,
/turf/open/floor/mineral/plastitanium/red{
	name = "base floor"
	},
/area/ruin/unpowered/syndicate_outpost)
"hf" = (
/obj/machinery/light/dim/directional/north,
/turf/open/floor/carpet,
/area/ruin/unpowered/syndicate_outpost)
"ho" = (
/turf/closed/wall/mineral/plastitanium,
/area/ruin/unpowered/syndicate_outpost)
"iT" = (
/obj/structure/table/reinforced,
/obj/item/storage/toolbox/syndicate,
/turf/open/floor/mineral/plastitanium/red{
	name = "base floor"
	},
/area/ruin/unpowered/syndicate_outpost)
"js" = (
/turf/open/floor/mineral/plastitanium/red{
	name = "base floor"
	},
/area/ruin/unpowered/syndicate_outpost)
"ql" = (
/obj/structure/table/reinforced,
/turf/open/floor/mineral/plastitanium/red{
	name = "base floor"
	},
/area/ruin/unpowered/syndicate_outpost)
"qp" = (
/obj/structure/chair/comfy/black{
	dir = 8
	},
/turf/open/floor/mineral/plastitanium/red{
	name = "base floor"
	},
/area/ruin/unpowered/syndicate_outpost)
"so" = (
/obj/machinery/telecomms/broadcaster,
/turf/open/floor/mineral/plastitanium/airless{
	name = "telecomms floor"
	},
/area/ruin/unpowered/syndicate_outpost)
"tX" = (
/obj/structure/closet/crate/grave/loot,
/turf/open/floor/plating/asteroid/basalt/lava_land_surface,
/area/overmap_encounter/planetoid/lava/explored)
"AV" = (
/obj/structure/table/reinforced,
/obj/item/paper/crumpled/awaymissions/moonoutpost19/hastey_note{
	desc = "It seems like it was written in a hurry";
	info = "<i>Hey, you're probably reading this after having killed me, but that's alright. I probably shot first. Names' Yuto, Syndicate Radio Operator, there used to be another op here, a nice one too. Had syndicate command not forgotten about this post, we'd of probably been executed for sentinmental attachments on the job. Although she didn't have to worry about that, the local fauna got her first. I guess this note is my way of saying sorry. Take what you want from this station and my body, you need it more than I do now. Good luck out there, whoever you are. - Syndicate Radio</i><br><br><i>e f.</i>";
	pixel_x = -3;
	pixel_y = 2
	},
/obj/item/candle{
	pixel_x = 8;
	pixel_y = 5
	},
/turf/open/floor/carpet,
/area/ruin/unpowered/syndicate_outpost)
"Cs" = (
/obj/item/trash/sosjerky{
	pixel_x = -9;
	pixel_y = 16
	},
/turf/open/floor/mineral/plastitanium{
	name = "base floor"
	},
/area/ruin/unpowered/syndicate_outpost)
"DJ" = (
/obj/machinery/light/dim/directional/west,
/turf/open/floor/mineral/plastitanium/red{
	name = "base floor"
	},
/area/ruin/unpowered/syndicate_outpost)
"Em" = (
/obj/machinery/light/dim/directional/south,
/turf/open/floor/mineral/plastitanium{
	name = "base floor"
	},
/area/ruin/unpowered/syndicate_outpost)
"Et" = (
/obj/machinery/vending/cigarette/syndicate,
/turf/open/floor/carpet/black,
/area/ruin/unpowered/syndicate_outpost)
"EJ" = (
/obj/machinery/vending/sustenance,
/turf/open/floor/carpet/black,
/area/ruin/unpowered/syndicate_outpost)
"EW" = (
/turf/open/floor/plating/asteroid/basalt/lava_land_surface,
/area/overmap_encounter/planetoid/lava/explored)
"Fe" = (
/obj/machinery/door/airlock/hatch{
	dir = 4
	},
/turf/open/floor/mineral/plastitanium/red{
	name = "base floor"
	},
/area/ruin/unpowered/syndicate_outpost)
"Hz" = (
/obj/structure/table/reinforced,
/obj/item/flashlight/lantern/lanternbang,
/turf/open/floor/mineral/plastitanium/red{
	name = "base floor"
	},
/area/ruin/unpowered/syndicate_outpost)
"II" = (
/obj/structure/table/reinforced,
/obj/item/trash/syndi_cakes{
	pixel_y = 13
	},
/turf/open/floor/mineral/plastitanium/red{
	name = "base floor"
	},
/area/ruin/unpowered/syndicate_outpost)
"JO" = (
/obj/machinery/door/airlock/highsecurity{
	hackProof = 1;
	name = "Secure Airlock"
	},
/turf/open/floor/mineral/plastitanium{
	name = "base floor"
	},
/area/ruin/unpowered/syndicate_outpost)
"Kq" = (
/obj/structure/chair/comfy/black,
/turf/open/floor/carpet,
/area/ruin/unpowered/syndicate_outpost)
"Kw" = (
/obj/machinery/telecomms/receiver,
/turf/open/floor/mineral/plastitanium/airless{
	name = "telecomms floor"
	},
/area/ruin/unpowered/syndicate_outpost)
"Lu" = (
/obj/effect/spawner/structure/window/plasma/reinforced/plastitanium,
/turf/open/floor/plating,
/area/ruin/unpowered/syndicate_outpost)
"NT" = (
/turf/open/floor/mineral/plastitanium{
	name = "base floor"
	},
/area/ruin/unpowered/syndicate_outpost)
"OA" = (
/obj/structure/window/reinforced/survival_pod{
	dir = 1;
	name = "window"
	},
/turf/open/floor/mineral/plastitanium/airless{
	name = "telecomms floor"
	},
/area/ruin/unpowered/syndicate_outpost)
"Pi" = (
/obj/structure/bed/dogbed{
	desc = "A well worn dog bed, wait... are dog beds supposed to have burn marks?."
	},
/mob/living/simple_animal/hostile/asteroid/basilisk/watcher/magmawing{
	desc = "A domesticated Magmawing watcher, you weren't aware that was even possible. Unfortunately though, it's been domesticated by the Syndicate..";
	dir = 4;
	faction = list("Syndicate");
	movement_type = 1
	},
/turf/open/floor/mineral/plastitanium{
	name = "base floor"
	},
/area/ruin/unpowered/syndicate_outpost)
"PG" = (
/turf/closed/wall/mineral/plastitanium/interior,
/area/ruin/unpowered/syndicate_outpost)
"PX" = (
/turf/open/floor/carpet,
/area/ruin/unpowered/syndicate_outpost)
"SD" = (
/obj/structure/closet/crate,
/obj/item/clothing/gloves/combat,
/obj/item/gun/ballistic/automatic/pistol,
/obj/item/ammo_box/magazine/pistolm9mm,
/obj/item/ammo_box/magazine/pistolm9mm,
/obj/item/ammo_box/magazine/pistolm9mm,
/turf/open/floor/carpet/black,
/area/ruin/unpowered/syndicate_outpost)
"SM" = (
/obj/machinery/light/dim/directional/west,
/turf/open/floor/mineral/plastitanium{
	name = "base floor"
	},
/area/ruin/unpowered/syndicate_outpost)
"Ts" = (
/mob/living/simple_animal/hostile/syndicate/ranged{
	dir = 8;
	health = 125;
	name = "Syndicate Radio Operative"
	},
/turf/open/floor/mineral/plastitanium/red{
	name = "base floor"
	},
/area/ruin/unpowered/syndicate_outpost)
"VY" = (
/obj/machinery/telecomms/bus,
/turf/open/floor/mineral/plastitanium/airless{
	name = "telecomms floor"
	},
/area/ruin/unpowered/syndicate_outpost)
"Wt" = (
/turf/template_noop,
/area/template_noop)
"WA" = (
/obj/machinery/portable_atmospherics/canister/air,
/turf/open/floor/mineral/plastitanium/red{
	name = "base floor"
	},
/area/ruin/unpowered/syndicate_outpost)
"WS" = (
/turf/open/floor/carpet/black,
/area/ruin/unpowered/syndicate_outpost)
"Xz" = (
/obj/machinery/door/window,
/turf/open/floor/mineral/plastitanium/red{
	name = "base floor"
	},
/area/ruin/unpowered/syndicate_outpost)
"XB" = (
/obj/structure/window/reinforced/survival_pod{
	dir = 1;
	name = "Window"
	},
/turf/open/floor/mineral/plastitanium/airless{
	name = "telecomms floor"
	},
/area/ruin/unpowered/syndicate_outpost)
"ZH" = (
/obj/machinery/door/airlock/hatch,
/turf/open/floor/mineral/plastitanium{
	name = "base floor"
	},
/area/ruin/unpowered/syndicate_outpost)

(1,1,1) = {"
EW
EW
EW
EW
EW
EW
EW
EW
Wt
Wt
Wt
Wt
Wt
Wt
"}
(2,1,1) = {"
EW
ho
ho
ho
JO
ho
ho
EW
EW
Wt
Wt
Wt
Wt
Wt
"}
(3,1,1) = {"
EW
ho
Pi
SM
NT
NT
ho
ho
EW
EW
EW
EW
EW
Wt
"}
(4,1,1) = {"
EW
Lu
NT
Cs
NT
NT
NT
ho
ho
ho
ho
ho
EW
EW
"}
(5,1,1) = {"
EW
Lu
II
fZ
ql
ql
NT
NT
PG
Et
EJ
ho
ho
EW
"}
(6,1,1) = {"
EW
Lu
js
qp
js
Hz
NT
NT
ZH
PX
WS
SD
ho
EW
"}
(7,1,1) = {"
EW
ho
js
Ts
js
Xz
NT
Em
PG
hf
PX
WS
ho
EW
"}
(8,1,1) = {"
EW
ho
PG
PG
Fe
PG
PG
PG
PG
Kq
AV
cO
ho
EW
"}
(9,1,1) = {"
EW
ho
bA
DJ
js
js
OA
so
PG
Lu
Lu
Lu
ho
EW
"}
(10,1,1) = {"
EW
ho
ho
eF
js
js
fa
VY
ho
EW
EW
EW
EW
EW
"}
(11,1,1) = {"
EW
EW
ho
ho
iT
WA
XB
Kw
ho
tX
EW
EW
EW
Wt
"}
(12,1,1) = {"
Wt
EW
EW
ho
ho
ho
ho
ho
ho
EW
EW
EW
EW
Wt
"}
(13,1,1) = {"
Wt
Wt
EW
EW
EW
EW
EW
EW
EW
EW
EW
EW
Wt
Wt
"}
