//MAP CONVERTED BY dmm2tgm.py THIS HEADER COMMENT PREVENTS RECONVERSION, DO NOT REMOVE
"c" = (
/turf/closed/wall/mineral/iron,
/area/ruin/powered)
"e" = (
/obj/item/clothing/suit/space/orange,
/turf/open/floor/plating/asteroid/basalt,
/area/ruin/powered)
"f" = (
/turf/open/floor/plating/asteroid/basalt,
/area/ruin/powered)
"g" = (
/turf/open/floor/plating/asteroid{
	name = "dirt"
	},
/area/ruin/powered)
"h" = (
/obj/item/shovel,
/turf/open/floor/plating/asteroid{
	name = "dirt"
	},
/area/ruin/powered)
"i" = (
/obj/item/reagent_containers/glass/bucket,
/turf/open/floor/plating/asteroid{
	name = "dirt"
	},
/area/ruin/powered)
"j" = (
/obj/structure/sink/puddle,
/turf/open/floor/plating/asteroid{
	name = "dirt"
	},
/area/ruin/powered)
"k" = (
/obj/structure/glowshroom/single,
/turf/open/floor/plating/asteroid{
	name = "dirt"
	},
/area/ruin/powered)
"l" = (
/obj/item/storage/toolbox/emergency,
/turf/open/floor/plating/asteroid{
	name = "dirt"
	},
/area/ruin/powered)
"m" = (
/obj/structure/rack,
/obj/item/seeds/reishi,
/obj/item/seeds/plump,
/obj/item/seeds/plump,
/obj/item/reagent_containers/food/snacks/grown/mushroom/glowshroom,
/obj/item/seeds/tower,
/turf/open/floor/plating/asteroid/basalt,
/area/ruin/powered)
"n" = (
/obj/machinery/hydroponics/soil,
/turf/open/floor/plating,
/area/ruin/powered)
"o" = (
/turf/open/floor/plating,
/area/ruin/powered)
"p" = (
/obj/structure/rack,
/obj/item/storage/bag/plants/portaseeder,
/obj/item/storage/bag/ore,
/obj/item/storage/firstaid/regular,
/turf/open/floor/plating/asteroid/basalt,
/area/ruin/powered)
"q" = (
/obj/structure/glowshroom/single,
/turf/open/floor/plating,
/area/ruin/powered)
"r" = (
/obj/structure/rack,
/obj/item/pickaxe/emergency,
/obj/item/tank/internals/oxygen,
/turf/open/floor/plating/asteroid/basalt,
/area/ruin/powered)
"t" = (
/turf/closed/wall/mineral/titanium/survival/pod,
/area/ruin/powered)
"u" = (
/obj/structure/bed/pod,
/obj/item/bedsheet/black,
/turf/open/floor/plating,
/area/ruin/powered)
"v" = (
/obj/structure/fans,
/turf/open/floor/pod/dark,
/area/ruin/powered)
"w" = (
/obj/machinery/smartfridge/survival_pod,
/turf/open/floor/pod/dark,
/area/ruin/powered)
"x" = (
/obj/effect/mob_spawn/human/hermit,
/turf/open/floor/pod/dark,
/area/ruin/powered)
"y" = (
/turf/open/floor/pod/dark,
/area/ruin/powered)
"A" = (
/obj/structure/table,
/obj/item/kitchen/knife/combat/survival,
/turf/open/floor/plating,
/area/ruin/powered)
"B" = (
/obj/structure/table/survival_pod,
/turf/open/floor/pod/dark,
/area/ruin/powered)
"C" = (
/obj/structure/tubes,
/obj/item/crowbar,
/obj/effect/decal/cleanable/blood/drip,
/turf/open/floor/pod/dark,
/area/ruin/powered)
"D" = (
/obj/effect/decal/cleanable/blood/footprints{
	dir = 1
	},
/obj/machinery/door/airlock/survival_pod/glass,
/obj/structure/fans/tiny,
/turf/open/floor/pod/dark,
/area/ruin/powered)
"E" = (
/obj/structure/shuttle/engine/propulsion/burst{
	dir = 8
	},
/turf/closed/wall/mineral/titanium/interior,
/area/ruin/powered)
"F" = (
/turf/closed/wall/mineral/titanium,
/area/ruin/powered)
"G" = (
/turf/closed/wall/mineral/titanium/interior,
/area/ruin/powered)
"H" = (
/obj/machinery/door/airlock/titanium{
	name = "Escape Pod Airlock"
	},
/turf/open/floor/mineral/titanium/blue,
/area/ruin/powered)
"I" = (
/obj/structure/chair{
	dir = 4
	},
/turf/open/floor/mineral/titanium/blue,
/area/ruin/powered)
"J" = (
/obj/effect/spawner/structure/window/shuttle,
/turf/open/floor/plating{
	initial_gas_mix = "LAVALAND_ATMOS"
	},
/area/ruin/powered)
"K" = (
/turf/closed/mineral/volcanic/lava_land_surface,
/area/overmap_encounter/planetoid/cave/explored)
"L" = (
/obj/machinery/hydroponics/soil,
/obj/item/cultivator,
/turf/open/floor/plating,
/area/ruin/powered)
"M" = (
/obj/machinery/portable_atmospherics/canister/oxygen,
/turf/open/floor/plating/asteroid/basalt,
/area/ruin/powered)
"P" = (
/turf/template_noop,
/area/template_noop)
"R" = (
/turf/open/floor/plating/asteroid/basalt/lava_land_surface,
/area/overmap_encounter/planetoid/lava/explored)
"S" = (
/obj/item/clothing/head/helmet/space/orange,
/turf/open/floor/plating/asteroid{
	name = "dirt"
	},
/area/ruin/powered)
"V" = (
/obj/machinery/light/small/directional/east,
/obj/structure/tubes,
/turf/open/floor/plating,
/area/ruin/powered)

(1,1,1) = {"
P
P
P
P
P
P
P
P
P
P
P
P
P
P
P
P
"}
(2,1,1) = {"
P
P
P
P
P
P
P
P
P
P
P
R
R
R
P
P
"}
(3,1,1) = {"
P
P
P
P
P
K
K
K
K
K
R
R
R
R
R
P
"}
(4,1,1) = {"
P
P
P
K
K
K
K
K
K
K
K
R
R
R
R
P
"}
(5,1,1) = {"
P
P
K
K
K
K
c
K
t
t
t
t
t
R
R
R
"}
(6,1,1) = {"
P
K
K
K
K
K
L
n
t
v
x
B
t
R
R
R
"}
(7,1,1) = {"
K
K
K
K
K
m
o
o
t
w
y
y
D
R
R
R
"}
(8,1,1) = {"
K
K
K
K
c
f
o
q
o
o
V
C
t
R
R
R
"}
(9,1,1) = {"
K
K
f
i
g
f
f
o
o
o
t
t
t
R
R
R
"}
(10,1,1) = {"
K
K
S
j
g
g
f
f
u
o
A
K
P
R
R
R
"}
(11,1,1) = {"
K
c
e
h
l
c
p
r
c
c
c
K
P
P
R
R
"}
(12,1,1) = {"
K
K
K
k
M
K
K
K
K
K
K
P
P
E
H
E
"}
(13,1,1) = {"
K
K
K
K
K
K
K
K
K
K
P
P
P
F
I
F
"}
(14,1,1) = {"
K
K
K
K
K
K
K
K
K
P
P
P
P
F
I
F
"}
(15,1,1) = {"
P
P
K
K
P
P
P
P
P
P
P
P
P
G
J
G
"}
(16,1,1) = {"
P
P
P
P
P
P
P
P
P
P
P
P
P
P
P
P
"}
