//MAP CONVERTED BY dmm2tgm.py THIS HEADER COMMENT PREVENTS RECONVERSION, DO NOT REMOVE
"a" = (
/turf/template_noop,
/area/template_noop)
"d" = (
/turf/closed/wall/mineral/titanium/survival/pod,
/area/ruin/powered)
"f" = (
/obj/structure/fans,
/turf/open/floor/pod/dark,
/area/ruin/powered)
"g" = (
/obj/machinery/smartfridge/survival_pod/empty,
/turf/open/floor/pod/dark,
/area/ruin/powered)
"h" = (
/obj/item/gps/computer,
/obj/structure/tubes,
/turf/open/floor/pod/dark,
/area/ruin/powered)
"k" = (
/obj/machinery/sleeper/survival_pod,
/turf/open/floor/pod/dark,
/area/ruin/powered)
"l" = (
/obj/item/pickaxe,
/obj/effect/decal/cleanable/blood,
/turf/open/floor/pod/dark,
/area/ruin/powered)
"p" = (
/obj/structure/table/survival_pod,
/obj/item/kitchen/knife/combat/survival,
/turf/open/floor/pod/dark,
/area/ruin/powered)
"q" = (
/obj/effect/mob_spawn/human/miner/explorer{
	brute_damage = 150;
	oxy_damage = 50
	},
/obj/effect/decal/cleanable/blood,
/obj/effect/decal/cleanable/blood/drip,
/obj/effect/decal/cleanable/blood/footprints{
	dir = 1
	},
/turf/open/floor/pod/dark,
/area/ruin/powered)
"r" = (
/obj/structure/tubes,
/obj/item/crowbar,
/obj/effect/decal/cleanable/blood/drip,
/turf/open/floor/pod/dark,
/area/ruin/powered)
"t" = (
/obj/effect/decal/cleanable/blood/footprints{
	dir = 1
	},
/obj/machinery/door/airlock/survival_pod/glass,
/turf/open/floor/pod/dark,
/area/ruin/powered)
"C" = (
/obj/effect/decal/cleanable/blood/drip,
/turf/open/floor/plating/asteroid/basalt/lava_land_surface,
/area/overmap_encounter/planetoid/lava/explored)
"D" = (
/obj/effect/decal/cleanable/blood/footprints{
	dir = 8
	},
/obj/effect/decal/cleanable/blood/drip,
/turf/open/floor/plating/asteroid/basalt/lava_land_surface,
/area/overmap_encounter/planetoid/lava/explored)
"E" = (
/obj/effect/decal/cleanable/blood/footprints{
	dir = 8
	},
/obj/effect/decal/cleanable/blood/footprints,
/turf/open/floor/plating/asteroid/basalt/lava_land_surface,
/area/overmap_encounter/planetoid/lava/explored)
"F" = (
/obj/structure/bed/pod,
/obj/item/bedsheet/black,
/obj/structure/tubes,
/obj/machinery/light/small/directional/east,
/turf/open/floor/pod/dark,
/area/ruin/powered)
"H" = (
/turf/open/floor/plating/asteroid/basalt/lava_land_surface,
/area/overmap_encounter/planetoid/lava/explored)
"I" = (
/obj/structure/sign/mining/survival{
	dir = 4;
	pixel_x = 32
	},
/turf/open/floor/plating/asteroid/basalt/lava_land_surface,
/area/overmap_encounter/planetoid/lava/explored)
"J" = (
/obj/effect/decal/cleanable/blood/footprints{
	dir = 8
	},
/turf/open/floor/plating/asteroid/basalt/lava_land_surface,
/area/overmap_encounter/planetoid/lava/explored)
"L" = (
/obj/effect/decal/cleanable/blood/drip,
/obj/effect/decal/cleanable/blood/footprints{
	dir = 1
	},
/turf/open/floor/plating/asteroid/basalt/lava_land_surface,
/area/overmap_encounter/planetoid/lava/explored)
"M" = (
/obj/structure/sign/mining/survival{
	dir = 8;
	pixel_x = -32
	},
/turf/open/floor/plating/asteroid/basalt/lava_land_surface,
/area/overmap_encounter/planetoid/lava/explored)
"O" = (
/obj/structure/sign/mining/survival{
	pixel_y = -32
	},
/turf/open/floor/plating/asteroid/basalt/lava_land_surface,
/area/overmap_encounter/planetoid/lava/explored)
"R" = (
/obj/effect/decal/cleanable/blood/footprints,
/obj/effect/decal/cleanable/blood/drip,
/turf/open/floor/plating/asteroid/basalt/lava_land_surface,
/area/overmap_encounter/planetoid/lava/explored)
"S" = (
/obj/effect/decal/cleanable/blood,
/mob/living/simple_animal/hostile/asteroid/goliath/beast{
	health = 0
	},
/turf/open/floor/plating/asteroid/basalt/lava_land_surface,
/area/overmap_encounter/planetoid/lava/explored)
"U" = (
/obj/effect/decal/cleanable/blood/footprints,
/turf/open/floor/plating/asteroid/basalt/lava_land_surface,
/area/overmap_encounter/planetoid/lava/explored)
"V" = (
/obj/effect/decal/cleanable/blood,
/turf/open/floor/plating/asteroid/basalt/lava_land_surface,
/area/overmap_encounter/planetoid/lava/explored)
"Y" = (
/obj/structure/sign/mining{
	pixel_y = 32
	},
/obj/effect/decal/cleanable/blood/footprints{
	dir = 8
	},
/turf/open/floor/plating/asteroid/basalt/lava_land_surface,
/area/overmap_encounter/planetoid/lava/explored)
"Z" = (
/obj/structure/sign/mining/survival{
	pixel_y = 32
	},
/turf/open/floor/plating/asteroid/basalt/lava_land_surface,
/area/overmap_encounter/planetoid/lava/explored)

(1,1,1) = {"
a
a
a
H
H
H
H
H
a
a
a
"}
(2,1,1) = {"
a
a
H
H
I
H
I
H
H
a
a
"}
(3,1,1) = {"
a
a
H
d
d
d
d
d
H
a
a
"}
(4,1,1) = {"
a
H
O
d
f
k
p
d
Z
H
H
"}
(5,1,1) = {"
a
H
H
d
g
l
q
t
L
H
H
"}
(6,1,1) = {"
H
H
O
d
h
F
r
d
Y
H
H
"}
(7,1,1) = {"
a
H
H
d
d
d
d
d
J
C
C
"}
(8,1,1) = {"
a
a
H
H
M
H
M
D
R
H
H
"}
(9,1,1) = {"
a
a
H
H
C
V
U
E
a
a
a
"}
(10,1,1) = {"
a
a
a
a
a
S
C
H
a
a
a
"}
