//MAP CONVERTED BY dmm2tgm.py THIS HEADER COMMENT PREVENTS RECONVERSION, DO NOT REMOVE
"ao" = (
/obj/structure/table_frame/wood,
/turf/open/floor/plating/asteroid/basalt/lava_land_surface,
/area/ruin/unpowered/crashsite/pinnance)
"aJ" = (
/obj/effect/turf_decal/industrial/warning,
/obj/effect/decal/cleanable/dirt/dust,
/obj/machinery/atmospherics/components/unary/outlet_injector/layer4,
/turf/open/floor/plating/rust,
/area/ruin/unpowered/crashsite/pinnance)
"bN" = (
/obj/structure/table,
/obj/machinery/atmospherics/components/unary/vent_scrubber/layer4,
/obj/item/storage/toolbox/mechanical,
/obj/structure/railing,
/turf/open/floor/plasteel/tech/grid,
/area/ruin/unpowered/crashsite/pinnance)
"bS" = (
/obj/structure/girder/displaced,
/turf/open/floor/plating,
/area/ruin/unpowered/crashsite/pinnance)
"cb" = (
/obj/machinery/atmospherics/pipe/simple/supply/hidden/layer2{
	dir = 8
	},
/obj/machinery/atmospherics/pipe/simple/scrubbers/hidden/layer4{
	dir = 4
	},
/obj/item/stack/cable_coil/cut/red,
/turf/open/floor/plating,
/area/ruin/unpowered/crashsite/pinnance)
"dF" = (
/turf/open/floor/plating/asteroid/basalt/lava_land_surface,
/area/overmap_encounter/planetoid/lava/explored)
"el" = (
/turf/closed/mineral,
/area/overmap_encounter/planetoid/cave/explored)
"es" = (
/obj/item/stack/ore/salvage/scraptitanium,
/obj/item/chair/plastic,
/turf/open/floor/plating/asteroid/basalt/lava_land_surface,
/area/overmap_encounter/planetoid/lava/explored)
"fn" = (
/obj/item/stack/cable_coil/cut/red,
/turf/open/floor/plating/asteroid/basalt/lava_land_surface,
/area/ruin/unpowered/crashsite/pinnance)
"gg" = (
/obj/machinery/power/shuttle/engine/electric/premium{
	dir = 4;
	desc = "An expensive variant of a standard ion thruster, using highest quality components in order to achieve much better performance. This one seems broken beyond restoration"
	},
/obj/structure/cable{
	icon_state = "0-4"
	},
/turf/open/floor/plating,
/area/ruin/unpowered/crashsite/pinnance)
"gk" = (
/obj/structure/rack,
/obj/effect/decal/cleanable/dirt/dust,
/obj/machinery/light/directional/west,
/obj/structure/windoor_assembly{
	dir = 2
	},
/obj/effect/spawner/lootdrop/maintenance/two,
/turf/open/floor/plating/rust,
/area/ruin/unpowered/crashsite/pinnance)
"gD" = (
/obj/structure/lattice,
/obj/item/stack/ore/salvage/scraptitanium/five,
/turf/open/floor/plating/asteroid/basalt/lava_land_surface,
/area/ruin/unpowered/crashsite/pinnance)
"hx" = (
/obj/machinery/power/smes/shuttle/precharged{
	dir = 8
	},
/obj/structure/window/reinforced{
	dir = 8
	},
/obj/structure/cable{
	icon_state = "0-8"
	},
/turf/open/floor/plasteel/tech/grid,
/area/ruin/unpowered/crashsite/pinnance)
"hN" = (
/obj/structure/chair/office{
	dir = 4
	},
/obj/machinery/atmospherics/pipe/simple/scrubbers/hidden/layer4{
	dir = 9
	},
/obj/effect/decal/cleanable/dirt/dust,
/obj/effect/decal/cleanable/blood/gibs/limb,
/obj/effect/decal/cleanable/blood/gibs/limb,
/obj/effect/decal/cleanable/blood/old,
/turf/open/floor/plasteel/mono/white,
/area/ruin/unpowered/crashsite/pinnance)
"iZ" = (
/turf/closed/mineral,
/area/ruin/unpowered/crashsite/pinnance)
"jS" = (
/obj/effect/decal/cleanable/dirt/dust,
/turf/open/floor/plasteel/dark,
/area/ruin/unpowered/crashsite/pinnance)
"kW" = (
/obj/structure/chair/office{
	dir = 1;
	name = "thinking chair";
	desc = "You sit in this. Innovation flows from there."
	},
/obj/effect/decal/cleanable/dirt/dust,
/turf/open/floor/plating,
/area/ruin/unpowered/crashsite/pinnance)
"ln" = (
/obj/structure/lattice,
/obj/item/stack/sheet/mineral/wood,
/turf/open/floor/plating/asteroid/basalt/lava_land_surface,
/area/ruin/unpowered/crashsite/pinnance)
"lI" = (
/obj/machinery/atmospherics/pipe/simple/supply/hidden/layer2{
	dir = 8
	},
/obj/machinery/atmospherics/pipe/simple/scrubbers/hidden/layer4{
	dir = 4
	},
/obj/effect/decal/cleanable/robot_debris,
/obj/item/broken_bottle,
/obj/item/stack/cable_coil/cut/red,
/turf/open/floor/plating,
/area/ruin/unpowered/crashsite/pinnance)
"ni" = (
/turf/open/floor/plating/asteroid/basalt/lava_land_surface,
/area/ruin/unpowered/crashsite/pinnance)
"nO" = (
/obj/effect/decal/cleanable/dirt/dust,
/turf/open/floor/plasteel,
/area/ruin/unpowered/crashsite/pinnance)
"oT" = (
/obj/machinery/airalarm/directional/south,
/obj/effect/turf_decal/corner_techfloor_grid,
/obj/effect/turf_decal/corner_techfloor_grid{
	dir = 8
	},
/obj/effect/turf_decal/industrial/warning/corner{
	dir = 4
	},
/obj/effect/decal/cleanable/greenglow,
/turf/open/floor/plasteel/tech/techmaint,
/area/ruin/unpowered/crashsite/pinnance)
"rr" = (
/turf/closed/wall/mineral/titanium/nodiagonal,
/area/ruin/unpowered/crashsite/pinnance)
"rt" = (
/obj/structure/cable{
	icon_state = "0-5"
	},
/obj/machinery/power/terminal{
	dir = 8
	},
/obj/effect/turf_decal/corner_techfloor_grid/full{
	dir = 1
	},
/turf/open/floor/plating,
/area/ruin/unpowered/crashsite/pinnance)
"rV" = (
/obj/structure/rack,
/obj/effect/decal/cleanable/dirt/dust,
/obj/structure/windoor_assembly,
/obj/item/flashlight/glowstick,
/turf/open/floor/plating/rust,
/area/ruin/unpowered/crashsite/pinnance)
"sM" = (
/obj/item/clothing/glasses/cheapsuns,
/turf/open/floor/plating/asteroid/basalt/lava_land_surface,
/area/overmap_encounter/planetoid/lava/explored)
"uc" = (
/obj/item/stack/ore/salvage/scraptitanium/five,
/turf/open/floor/plating/asteroid/basalt/lava_land_surface,
/area/overmap_encounter/planetoid/lava/explored)
"uA" = (
/obj/effect/turf_decal/industrial/warning/corner{
	dir = 8
	},
/turf/open/floor/plating/rust,
/area/ruin/unpowered/crashsite/pinnance)
"uV" = (
/obj/machinery/atmospherics/pipe/simple/supply/hidden/layer2{
	dir = 5
	},
/obj/effect/turf_decal/corner_techfloor_grid{
	dir = 9
	},
/obj/item/light/tube/broken,
/obj/structure/light_construct/directional/west,
/obj/effect/decal/cleanable/dirt/dust,
/turf/open/floor/plasteel/tech/techmaint,
/area/ruin/unpowered/crashsite/pinnance)
"vv" = (
/obj/effect/decal/cleanable/ash/large,
/turf/open/floor/plating/asteroid/basalt/lava_land_surface,
/area/ruin/unpowered/crashsite/pinnance)
"vH" = (
/obj/structure/rack,
/obj/effect/decal/cleanable/dirt/dust,
/obj/machinery/light/broken/directional/west,
/obj/structure/windoor_assembly,
/turf/open/floor/plating/rust,
/area/ruin/unpowered/crashsite/pinnance)
"xe" = (
/obj/structure/lattice,
/turf/open/floor/plating/asteroid/basalt/lava_land_surface,
/area/ruin/unpowered/crashsite/pinnance)
"xo" = (
/obj/structure/frame/computer{
	dir = 8
	},
/obj/effect/turf_decal/industrial/outline/yellow,
/obj/item/stack/cable_coil/cut/red,
/turf/open/floor/plasteel/tech/grid,
/area/ruin/unpowered/crashsite/pinnance)
"xz" = (
/obj/structure/cable,
/obj/machinery/holopad/emergency/science,
/obj/machinery/atmospherics/pipe/simple/supply/hidden/layer2{
	dir = 5
	},
/obj/effect/decal/cleanable/dirt/dust,
/obj/item/shard,
/obj/machinery/power/apc/auto_name/directional/south{
	start_charge = 0
	},
/turf/open/floor/plasteel/mono/dark,
/area/ruin/unpowered/crashsite/pinnance)
"xI" = (
/obj/structure/cable{
	icon_state = "4-8"
	},
/obj/effect/turf_decal/industrial/warning/corner{
	dir = 1
	},
/obj/machinery/atmospherics/pipe/simple/supply/hidden/layer2{
	dir = 8
	},
/obj/machinery/atmospherics/pipe/simple/scrubbers/hidden/layer4{
	dir = 4
	},
/obj/structure/windoor_assembly{
	dir = 4
	},
/obj/item/stack/tile/plasteel,
/obj/effect/decal/cleanable/blood/tracks{
	dir = 4
	},
/turf/open/floor/plating,
/area/ruin/unpowered/crashsite/pinnance)
"xJ" = (
/obj/effect/decal/cleanable/dirt/dust,
/obj/structure/girder,
/obj/item/stack/ore/salvage/scraptitanium,
/turf/open/floor/plating,
/area/ruin/unpowered/crashsite/pinnance)
"yc" = (
/obj/effect/spawner/lootdrop/maintenance/two,
/turf/open/floor/plating/asteroid/basalt/lava_land_surface,
/area/overmap_encounter/planetoid/lava/explored)
"yD" = (
/obj/item/chair/plastic,
/turf/open/floor/plating/asteroid/basalt/lava_land_surface,
/area/ruin/unpowered/crashsite/pinnance)
"yG" = (
/obj/structure/cable{
	icon_state = "4-8"
	},
/obj/effect/turf_decal/industrial/warning{
	dir = 1
	},
/obj/machinery/atmospherics/pipe/manifold/scrubbers/visible/layer4,
/obj/machinery/atmospherics/pipe/manifold/supply/hidden/layer2,
/obj/effect/decal/remains/human,
/obj/effect/decal/cleanable/blood/splatter,
/turf/open/floor/plasteel,
/area/ruin/unpowered/crashsite/pinnance)
"zb" = (
/obj/structure/lattice,
/obj/structure/flora/rock/pile,
/turf/open/floor/plating/asteroid/basalt/lava_land_surface,
/area/ruin/unpowered/crashsite/pinnance)
"zY" = (
/obj/effect/decal/cleanable/dirt/dust,
/turf/open/floor/plasteel/mono/dark,
/area/ruin/unpowered/crashsite/pinnance)
"Ag" = (
/obj/structure/girder,
/turf/open/floor/plating/asteroid/basalt/lava_land_surface,
/area/ruin/unpowered/crashsite/pinnance)
"Aq" = (
/obj/structure/chair/stool{
	dir = 4
	},
/obj/structure/window{
	dir = 8
	},
/obj/effect/decal/cleanable/dirt/dust,
/turf/open/floor/plasteel/dark,
/area/ruin/unpowered/crashsite/pinnance)
"AB" = (
/obj/structure/girder,
/obj/structure/lattice,
/turf/open/floor/plating/asteroid/basalt/lava_land_surface,
/area/ruin/unpowered/crashsite/pinnance)
"AN" = (
/obj/structure/cable{
	icon_state = "2-8"
	},
/obj/machinery/atmospherics/pipe/simple/supply/hidden/layer2{
	dir = 10
	},
/obj/machinery/atmospherics/pipe/simple/scrubbers/hidden/layer4{
	dir = 4
	},
/obj/item/stack/tile/plasteel,
/obj/effect/decal/cleanable/blood/tracks{
	dir = 4
	},
/turf/open/floor/plating,
/area/ruin/unpowered/crashsite/pinnance)
"AX" = (
/obj/structure/flora/rock,
/turf/open/floor/plating/asteroid/basalt/lava_land_surface,
/area/overmap_encounter/planetoid/lava/explored)
"Bv" = (
/obj/structure/flora/rock/pile,
/turf/open/floor/plating/asteroid/basalt/lava_land_surface,
/area/overmap_encounter/planetoid/lava/explored)
"Cm" = (
/obj/effect/decal/cleanable/robot_debris,
/obj/item/stack/tile/plasteel/dark,
/turf/open/floor/plating,
/area/ruin/unpowered/crashsite/pinnance)
"CY" = (
/obj/structure/cable{
	icon_state = "2-4"
	},
/obj/structure/cable{
	icon_state = "4-8"
	},
/obj/effect/turf_decal/corner_techfloor_grid{
	dir = 1
	},
/obj/effect/turf_decal/corner_techfloor_grid{
	dir = 4
	},
/obj/effect/decal/cleanable/plasma,
/turf/open/floor/plasteel/tech/techmaint,
/area/ruin/unpowered/crashsite/pinnance)
"DP" = (
/obj/structure/grille/broken,
/obj/item/shard,
/turf/open/floor/plating,
/area/ruin/unpowered/crashsite/pinnance)
"Fv" = (
/obj/effect/spawner/lootdrop/maintenance/two,
/turf/open/floor/plating/asteroid/basalt/lava_land_surface,
/area/ruin/unpowered/crashsite/pinnance)
"FD" = (
/obj/effect/turf_decal/industrial/warning/corner,
/turf/open/floor/plating/rust,
/area/ruin/unpowered/crashsite/pinnance)
"Gn" = (
/obj/machinery/atmospherics/pipe/layer_manifold,
/obj/effect/mapping_helpers/airlock/locked,
/obj/machinery/door/airlock/shuttle,
/turf/open/floor/plasteel/mono/white,
/area/ruin/unpowered/crashsite/pinnance)
"Gt" = (
/obj/structure/closet/wall/white{
	dir = 8;
	name = "survey gear";
	pixel_x = 30
	},
/obj/item/survey_handheld/elite,
/obj/item/survey_handheld/advanced,
/obj/item/survey_handheld/advanced,
/obj/item/clothing/accessory/armband/science,
/obj/item/clothing/suit/toggle/labcoat/science,
/obj/item/clothing/glasses/science,
/obj/item/tank/internals/oxygen,
/obj/effect/decal/cleanable/dirt/dust,
/turf/open/floor/plating,
/area/ruin/unpowered/crashsite/pinnance)
"Gw" = (
/obj/machinery/atmospherics/components/unary/portables_connector/visible/layer2,
/obj/effect/turf_decal/corner_techfloor_grid{
	dir = 9
	},
/turf/open/floor/plasteel/tech/techmaint,
/area/ruin/unpowered/crashsite/pinnance)
"Hy" = (
/obj/item/clothing/under/shorts/purple,
/turf/open/floor/plating/asteroid/basalt/lava_land_surface,
/area/overmap_encounter/planetoid/lava/explored)
"HM" = (
/obj/structure/cable{
	icon_state = "1-2"
	},
/obj/effect/decal/cleanable/ash,
/obj/effect/turf_decal/industrial/warning/corner,
/obj/effect/decal/cleanable/dirt/dust,
/obj/item/stack/ore/salvage/scrapplasma,
/turf/open/floor/plasteel/tech/techmaint,
/area/ruin/unpowered/crashsite/pinnance)
"Ik" = (
/obj/structure/lattice,
/obj/structure/fluff/beach_umbrella/science,
/turf/open/floor/plating/asteroid/basalt/lava_land_surface,
/area/ruin/unpowered/crashsite/pinnance)
"Is" = (
/obj/structure/bed,
/obj/structure/curtain,
/obj/item/shard,
/turf/open/floor/plasteel/mono/dark,
/area/ruin/unpowered/crashsite/pinnance)
"Iv" = (
/obj/machinery/atmospherics/components/unary/vent_pump/layer2{
	dir = 1
	},
/obj/structure/railing{
	dir = 1
	},
/obj/structure/railing{
	dir = 4
	},
/obj/effect/decal/cleanable/dirt/dust,
/turf/open/floor/plasteel/tech/grid,
/area/ruin/unpowered/crashsite/pinnance)
"IC" = (
/obj/machinery/power/shuttle/engine/electric/premium{
	dir = 4;
	desc = "An expensive variant of a standard ion thruster, using highest quality components in order to achieve much better performance. This one seems broken beyond restoration"
	},
/turf/open/floor/plating,
/area/ruin/unpowered/crashsite/pinnance)
"IU" = (
/obj/item/stack/ore/salvage/scraptitanium,
/turf/open/floor/plating/asteroid/basalt/lava_land_surface,
/area/overmap_encounter/planetoid/lava/explored)
"Jg" = (
/obj/structure/frame/machine,
/obj/machinery/light/small/broken/directional/west,
/turf/open/floor/plating,
/area/ruin/unpowered/crashsite/pinnance)
"JS" = (
/obj/structure/cable{
	icon_state = "0-8"
	},
/obj/effect/turf_decal/industrial/outline/yellow,
/obj/effect/decal/cleanable/cobweb/cobweb2,
/obj/effect/decal/cleanable/plasma,
/turf/open/floor/plasteel/tech/grid,
/area/ruin/unpowered/crashsite/pinnance)
"Lz" = (
/obj/machinery/atmospherics/components/unary/vent_pump/layer2{
	dir = 8
	},
/obj/effect/turf_decal/box,
/obj/structure/table_frame,
/turf/open/floor/plasteel/mono/dark,
/area/ruin/unpowered/crashsite/pinnance)
"LH" = (
/obj/structure/table{
	name = "thinking table"
	},
/turf/open/floor/plating,
/area/ruin/unpowered/crashsite/pinnance)
"Nf" = (
/obj/item/reagent_containers/food/snacks/canned/beans,
/obj/structure/sign/poster/official/science{
	pixel_y = -32
	},
/obj/effect/decal/cleanable/ash/large,
/obj/machinery/light/small/broken/directional/south,
/obj/item/shard,
/obj/structure/table_frame,
/turf/open/floor/plasteel/mono/dark,
/area/ruin/unpowered/crashsite/pinnance)
"NB" = (
/obj/structure/flora/rock,
/turf/open/floor/plating/asteroid/basalt/lava_land_surface,
/area/ruin/unpowered/crashsite/pinnance)
"NR" = (
/obj/machinery/atmospherics/pipe/simple/scrubbers/hidden/layer4,
/obj/item/shard,
/turf/open/floor/plasteel/mono/white,
/area/ruin/unpowered/crashsite/pinnance)
"Oa" = (
/turf/closed/wall/mineral/titanium,
/area/ruin/unpowered/crashsite/pinnance)
"Ol" = (
/obj/structure/girder,
/obj/item/stack/ore/salvage/scraptitanium,
/turf/open/floor/plating,
/area/ruin/unpowered/crashsite/pinnance)
"Om" = (
/obj/structure/girder/displaced,
/obj/item/stack/ore/salvage/scraptitanium/five,
/turf/open/floor/plating,
/area/ruin/unpowered/crashsite/pinnance)
"Oz" = (
/obj/machinery/atmospherics/pipe/simple/supply/hidden/layer2{
	dir = 8
	},
/obj/machinery/atmospherics/pipe/simple/scrubbers/hidden/layer4{
	dir = 4
	},
/obj/item/stack/cable_coil/cut/red,
/turf/open/floor/plating/rust,
/area/ruin/unpowered/crashsite/pinnance)
"OL" = (
/obj/machinery/door/window{
	dir = 8
	},
/obj/structure/cable{
	icon_state = "4-8"
	},
/obj/machinery/atmospherics/pipe/simple/supply/hidden/layer2{
	dir = 8
	},
/obj/machinery/atmospherics/pipe/simple/scrubbers/hidden/layer4{
	dir = 4
	},
/obj/effect/turf_decal/industrial/warning{
	dir = 8
	},
/obj/structure/frame/computer{
	dir = 4
	},
/turf/open/floor/plasteel,
/area/ruin/unpowered/crashsite/pinnance)
"Po" = (
/obj/structure/chair/stool{
	dir = 8
	},
/obj/item/shard,
/turf/open/floor/plasteel/dark,
/area/ruin/unpowered/crashsite/pinnance)
"PM" = (
/obj/item/stack/ore/salvage/scraptitanium,
/obj/structure/flora/rock,
/turf/open/floor/plating/asteroid/basalt/lava_land_surface,
/area/overmap_encounter/planetoid/lava/explored)
"Rw" = (
/obj/effect/decal/cleanable/dirt/dust,
/obj/machinery/light/small/broken/directional/east,
/turf/open/floor/plating,
/area/ruin/unpowered/crashsite/pinnance)
"Tf" = (
/obj/structure/frame/computer{
	dir = 8
	},
/obj/effect/turf_decal/industrial/outline/yellow,
/obj/item/shard,
/turf/open/floor/plasteel/tech/grid,
/area/ruin/unpowered/crashsite/pinnance)
"Tl" = (
/obj/machinery/atmospherics/pipe/simple/scrubbers/hidden/layer4,
/obj/machinery/atmospherics/pipe/simple/supply/hidden/layer2,
/obj/structure/door_assembly/door_assembly_shuttle,
/turf/open/floor/plasteel/mono/white,
/area/ruin/unpowered/crashsite/pinnance)
"UO" = (
/obj/structure/cable{
	icon_state = "0-4"
	},
/obj/machinery/power/terminal{
	dir = 8
	},
/obj/effect/turf_decal/corner_techfloor_grid/full{
	dir = 4
	},
/obj/effect/decal/cleanable/cobweb,
/obj/machinery/power/port_gen/pacman,
/turf/open/floor/plating,
/area/ruin/unpowered/crashsite/pinnance)
"Ve" = (
/obj/machinery/atmospherics/components/binary/dp_vent_pump/on/layer2,
/obj/machinery/atmospherics/pipe/simple/scrubbers/hidden/layer4,
/obj/machinery/advanced_airlock_controller{
	pixel_x = 30
	},
/turf/open/floor/plating/rust,
/area/ruin/unpowered/crashsite/pinnance)
"Vf" = (
/obj/machinery/atmospherics/components/unary/vent_scrubber/layer4,
/obj/effect/turf_decal/box,
/obj/structure/table_frame,
/turf/open/floor/plasteel/mono/dark,
/area/ruin/unpowered/crashsite/pinnance)
"VS" = (
/obj/machinery/airalarm/directional/west,
/obj/effect/decal/cleanable/dirt/dust,
/obj/machinery/light/small/broken/directional/west,
/obj/item/bedsheet/rd,
/turf/open/floor/plating,
/area/ruin/unpowered/crashsite/pinnance)
"Wg" = (
/obj/effect/decal/cleanable/dirt/dust,
/obj/item/rack_parts,
/obj/structure/windoor_assembly{
	dir = 2
	},
/obj/effect/decal/cleanable/ash/large,
/turf/open/floor/plating/rust,
/area/ruin/unpowered/crashsite/pinnance)
"Wu" = (
/obj/structure/girder,
/turf/open/floor/plating/rust,
/area/ruin/unpowered/crashsite/pinnance)
"Wz" = (
/turf/template_noop,
/area/template_noop)
"WL" = (
/obj/effect/turf_decal/industrial/warning{
	dir = 8
	},
/obj/structure/window/reinforced{
	dir = 8
	},
/turf/open/floor/plasteel,
/area/ruin/unpowered/crashsite/pinnance)
"Xn" = (
/obj/structure/grille/broken,
/turf/open/floor/plating/rust,
/area/ruin/unpowered/crashsite/pinnance)
"Yf" = (
/turf/closed/indestructible/rock,
/area/overmap_encounter/planetoid/cave/explored)
"Yk" = (
/obj/effect/decal/cleanable/ash/large,
/turf/open/floor/plating/asteroid/basalt/lava_land_surface,
/area/overmap_encounter/planetoid/lava/explored)
"Yo" = (
/obj/structure/lattice,
/obj/effect/decal/cleanable/ash/large,
/turf/open/floor/plating/asteroid/basalt/lava_land_surface,
/area/ruin/unpowered/crashsite/pinnance)
"Zo" = (
/obj/structure/lattice,
/obj/item/stack/ore/salvage/scraptitanium,
/turf/open/floor/plating/asteroid/basalt/lava_land_surface,
/area/ruin/unpowered/crashsite/pinnance)
"Zu" = (
/obj/structure/cable{
	icon_state = "1-4"
	},
/obj/structure/cable{
	icon_state = "1-10"
	},
/obj/machinery/atmospherics/components/binary/pump/layer2{
	dir = 4
	},
/obj/effect/turf_decal/industrial/warning{
	dir = 4
	},
/obj/effect/decal/cleanable/dirt/dust,
/turf/open/floor/plasteel/tech/techmaint,
/area/ruin/unpowered/crashsite/pinnance)
"ZJ" = (
/obj/structure/cable{
	icon_state = "4-8"
	},
/obj/machinery/atmospherics/pipe/manifold/supply/hidden/layer2{
	dir = 1
	},
/obj/machinery/atmospherics/pipe/simple/scrubbers/hidden/layer4{
	dir = 5
	},
/turf/open/floor/plasteel/stairs{
	dir = 4
	},
/area/ruin/unpowered/crashsite/pinnance)
"ZM" = (
/obj/structure/girder,
/obj/item/stack/ore/salvage/scraptitanium/five,
/obj/structure/girder/displaced,
/turf/open/floor/plating,
/area/ruin/unpowered/crashsite/pinnance)
"ZO" = (
/obj/machinery/door/window{
	dir = 8
	},
/obj/structure/cable{
	icon_state = "4-8"
	},
/obj/effect/turf_decal/industrial/warning/corner{
	dir = 4
	},
/obj/machinery/atmospherics/pipe/simple/supply/hidden/layer2{
	dir = 8
	},
/obj/machinery/atmospherics/pipe/simple/scrubbers/hidden/layer4{
	dir = 4
	},
/turf/open/floor/plasteel,
/area/ruin/unpowered/crashsite/pinnance)

(1,1,1) = {"
Wz
Wz
Wz
Wz
Wz
Wz
Wz
Wz
Wu
rr
dF
Yk
Wz
Wz
Wz
Wz
Wz
Wz
Wz
Wz
dF
dF
dF
dF
dF
dF
Wz
Wz
Wz
Wz
"}
(2,1,1) = {"
Wz
Wz
Wz
Wz
Wz
Wz
Wz
Wz
dF
rr
rr
IC
dF
Wz
Wz
Wz
Wz
Wz
Wz
dF
dF
dF
dF
dF
dF
dF
Wz
Wz
Wz
Wz
"}
(3,1,1) = {"
Wz
Wz
Wz
Wz
Wz
Wz
Wz
Wz
Yk
vH
xe
fn
gD
dF
Yk
dF
dF
dF
dF
sM
dF
Yo
Oa
bS
xe
dF
Wz
Wz
Wz
Wz
"}
(4,1,1) = {"
Wz
Wz
Wz
Wz
Wz
Wz
Wz
Wz
dF
rV
xe
xe
xe
dF
uc
gg
Oa
dF
NB
ni
ni
Zo
Oa
Yf
xe
dF
Wz
Wz
Wz
Wz
"}
(5,1,1) = {"
Wz
Wz
Wz
Wz
Wz
Wz
Wz
Wz
AX
AB
Zo
Oa
hx
Oa
Oa
hx
Oa
xe
ni
yD
ni
ln
gk
dF
dF
dF
dF
Wz
Wz
Wz
"}
(6,1,1) = {"
Wz
Wz
Wz
Wz
Wz
Wz
Wz
Wz
dF
Zo
xe
Oa
UO
Gw
uV
rt
Oa
xe
ni
ao
Fv
xe
Wg
dF
dF
dF
Wz
Wz
Wz
Wz
"}
(7,1,1) = {"
Wz
Wz
Wz
Wz
Wz
Wz
Wz
Wz
dF
Bv
xe
Oa
CY
HM
Zu
oT
Oa
xe
Ik
ni
ni
xe
Ag
dF
dF
Wz
Wz
Wz
Wz
Wz
"}
(8,1,1) = {"
Wz
Wz
Wz
Wz
Wz
Wz
Wz
Wz
dF
dF
xe
Oa
JS
bN
ZJ
Iv
Oa
Yo
xe
dF
es
dF
PM
dF
Wz
Wz
Wz
Wz
Wz
Wz
"}
(9,1,1) = {"
Wz
Wz
Wz
Wz
Wz
Wz
Wz
Wz
Wz
dF
xe
Oa
Oa
Oa
OL
WL
Oa
xe
dF
Hy
yc
dF
dF
dF
Wz
Wz
Wz
Wz
Wz
Wz
"}
(10,1,1) = {"
Wz
Wz
Wz
Wz
Wz
Wz
Wz
Wz
Wz
dF
Yk
Oa
jS
Jg
lI
zY
xJ
dF
dF
Bv
dF
IU
dF
Wz
Wz
Wz
Wz
Wz
Wz
Wz
"}
(11,1,1) = {"
Wz
Wz
Wz
Wz
Wz
Wz
Wz
Wz
Wz
AX
dF
DP
LH
kW
Oz
xe
Yo
IU
Bv
dF
AX
dF
dF
Wz
Wz
Wz
Wz
Wz
Wz
Wz
"}
(12,1,1) = {"
Wz
Wz
Wz
Wz
Wz
Wz
Wz
Wz
Wz
dF
dF
Yo
xe
xe
xe
Cm
Xn
dF
dF
dF
dF
dF
Wz
Wz
Wz
Wz
Wz
Wz
Wz
Wz
"}
(13,1,1) = {"
Wz
Wz
Wz
Wz
Wz
Wz
Wz
Wz
Wz
Wz
dF
ni
ni
ni
ni
xe
vv
dF
dF
dF
dF
Bv
Wz
Wz
Wz
Wz
Wz
Wz
Wz
Wz
"}
(14,1,1) = {"
Wz
Wz
Wz
Wz
Wz
Wz
dF
Wz
Wz
Wz
dF
ni
zb
xe
Yo
xe
xe
xe
xe
dF
dF
dF
Wz
Wz
Wz
Wz
Wz
Wz
Wz
Wz
"}
(15,1,1) = {"
Wz
Wz
dF
dF
dF
dF
dF
dF
dF
dF
dF
dF
dF
Om
Gt
Rw
cb
nO
Oa
dF
dF
dF
Wz
Wz
Wz
dF
dF
dF
Wz
Wz
"}
(16,1,1) = {"
Wz
Wz
dF
el
dF
dF
AX
dF
dF
uc
AX
dF
FD
Oa
Oa
Oa
ZO
Aq
Oa
dF
dF
dF
Wz
Wz
AX
dF
el
el
Wz
Wz
"}
(17,1,1) = {"
Wz
Wz
Wz
el
el
el
dF
dF
dF
uc
dF
dF
aJ
Gn
Ve
Tl
yG
Nf
Oa
dF
dF
dF
dF
dF
dF
dF
el
el
el
Wz
"}
(18,1,1) = {"
Wz
Wz
Wz
el
el
el
el
dF
el
dF
dF
dF
uA
rr
Oa
Oa
xI
Po
Oa
dF
dF
dF
dF
dF
dF
el
el
el
el
Wz
"}
(19,1,1) = {"
Wz
Wz
Wz
Wz
el
el
el
el
el
el
dF
uc
dF
Oa
Is
VS
AN
xz
Oa
dF
AX
dF
Bv
el
el
el
el
el
Wz
Wz
"}
(20,1,1) = {"
Wz
Wz
Wz
Wz
el
el
el
el
el
el
Bv
dF
dF
Oa
Vf
NR
hN
Lz
Oa
dF
dF
dF
el
el
el
el
el
Wz
Wz
Wz
"}
(21,1,1) = {"
Wz
Wz
Wz
Wz
Wz
el
el
el
el
el
el
el
Bv
ZM
Oa
xo
Tf
Om
Oa
dF
Bv
Bv
el
el
el
el
Wz
Wz
Wz
Wz
"}
(22,1,1) = {"
Wz
Wz
Wz
Wz
Wz
Wz
el
el
el
el
el
el
el
bS
Oa
DP
DP
iZ
Ol
el
el
el
el
el
el
el
Wz
Wz
Wz
Wz
"}
(23,1,1) = {"
Wz
Wz
Wz
Wz
Wz
Wz
el
el
el
el
el
el
el
el
el
el
el
el
el
el
el
el
el
el
el
Wz
Wz
Wz
Wz
Wz
"}
(24,1,1) = {"
Wz
Wz
Wz
Wz
Wz
Wz
Wz
el
el
el
el
el
el
el
el
el
el
el
el
el
el
el
el
el
el
Wz
Wz
Wz
Wz
Wz
"}
(25,1,1) = {"
Wz
Wz
Wz
Wz
Wz
Wz
Wz
Wz
el
el
el
el
el
el
el
el
el
el
el
el
el
el
el
Wz
Wz
Wz
Wz
Wz
Wz
Wz
"}
(26,1,1) = {"
Wz
Wz
Wz
Wz
Wz
Wz
Wz
Wz
Wz
el
el
el
el
el
el
el
el
el
el
el
el
el
Wz
Wz
Wz
Wz
Wz
Wz
Wz
Wz
"}
(27,1,1) = {"
Wz
Wz
Wz
Wz
Wz
Wz
Wz
Wz
Wz
Wz
Wz
el
el
el
el
el
el
el
el
el
el
Wz
Wz
Wz
Wz
Wz
Wz
Wz
Wz
Wz
"}
(28,1,1) = {"
Wz
Wz
Wz
Wz
Wz
Wz
Wz
Wz
Wz
Wz
Wz
Wz
Wz
el
el
el
el
el
Wz
Wz
Wz
Wz
Wz
Wz
Wz
Wz
Wz
Wz
Wz
Wz
"}
(29,1,1) = {"
Wz
Wz
Wz
Wz
Wz
Wz
Wz
Wz
Wz
Wz
Wz
Wz
Wz
Wz
Wz
Wz
Wz
Wz
Wz
Wz
Wz
Wz
Wz
Wz
Wz
Wz
Wz
Wz
Wz
Wz
"}
(30,1,1) = {"
Wz
Wz
Wz
Wz
Wz
Wz
Wz
Wz
Wz
Wz
Wz
Wz
Wz
Wz
Wz
Wz
Wz
Wz
Wz
Wz
Wz
Wz
Wz
Wz
Wz
Wz
Wz
Wz
Wz
Wz
"}
