//MAP CONVERTED BY dmm2tgm.py THIS HEADER COMMENT PREVENTS RECONVERSION, DO NOT REMOVE
"aa" = (
/turf/closed/mineral/random/volcanic,
/area/lavaland/surface/outdoors)
"ab" = (
/obj/effect/decal/cleanable/blood,
/obj/machinery/light/broken,
/obj/item/stack/tile/mineral/titanium/blue,
/obj/item/storage/book/bible,
/turf/open/floor/plating,
/area/lavaland/surface/outdoors)
"ac" = (
/obj/item/ectoplasm,
/obj/effect/decal/cleanable/blood/drip{
	pixel_x = 11;
	pixel_y = -3
	},
/turf/open/floor/mineral/titanium,
/area/lavaland/surface/outdoors)
"ad" = (
/turf/closed/wall/mineral/titanium,
/area/lavaland/surface/outdoors)
"ae" = (
/obj/effect/decal/cleanable/blood/gibs,
/turf/open/floor/mineral/plastitanium/red,
/area/lavaland/surface/outdoors)
"af" = (
/obj/machinery/power/shuttle/engine/electric{
	dir = 1
	},
/turf/open/floor/plating,
/area/overmap_encounter/planetoid/cave/explored)
"ag" = (
/obj/effect/decal/cleanable/blood/drip{
	pixel_x = 13;
	pixel_y = 8
	},
/turf/open/floor/plating/asteroid/basalt/lava_land_surface,
/area/overmap_encounter/planetoid/cave/explored)
"ah" = (
/obj/item/stack/tile/mineral/plastitanium/red,
/obj/effect/decal/cleanable/blood/drip{
	pixel_y = -3
	},
/turf/open/floor/plating,
/area/lavaland/surface/outdoors)
"ai" = (
/obj/item/shard,
/obj/effect/decal/cleanable/glass,
/obj/effect/decal/cleanable/blood/drip{
	pixel_x = 8;
	pixel_y = 1
	},
/turf/open/floor/mineral/titanium,
/area/overmap_encounter/planetoid/cave/explored)
"aj" = (
/obj/machinery/power/shuttle/engine/electric{
	dir = 1
	},
/turf/open/floor/plating,
/area/lavaland/surface/outdoors)
"ak" = (
/obj/item/stack/tile/mineral/titanium,
/turf/open/floor/plating,
/area/lavaland/surface/outdoors)
"al" = (
/obj/structure/grille/broken,
/obj/effect/decal/cleanable/glass,
/obj/item/shard,
/turf/open/floor/plating,
/area/lavaland/surface/outdoors)
"am" = (
/obj/structure/table,
/obj/item/soulstone/anybody,
/obj/item/toy/plush/narplush,
/obj/machinery/light/broken{
	dir = 1
	},
/obj/structure/window/reinforced/spawner,
/obj/machinery/door/window/brigdoor/westright,
/obj/item/clothing/head/wizard/black,
/obj/item/clothing/suit/wizrobe/black,
/turf/open/floor/mineral/plastitanium/red,
/area/lavaland/surface/outdoors)
"an" = (
/obj/effect/decal/cleanable/blood,
/obj/effect/decal/cleanable/glass,
/obj/item/stack/rods,
/obj/item/stack/tile/mineral/titanium/blue,
/turf/open/floor/plating,
/area/lavaland/surface/outdoors)
"ao" = (
/obj/item/shard,
/obj/effect/decal/cleanable/glass,
/obj/effect/decal/cleanable/blood/drip{
	pixel_x = 8;
	pixel_y = 1
	},
/turf/open/floor/mineral/titanium,
/area/lavaland/surface/outdoors)
"ap" = (
/obj/effect/decal/cleanable/blood/drip{
	pixel_y = 10
	},
/turf/open/floor/plating/asteroid/basalt/lava_land_surface,
/area/overmap_encounter/planetoid/cave/explored)
"aq" = (
/obj/effect/decal/cleanable/blood/drip{
	pixel_x = 13;
	pixel_y = 8
	},
/turf/open/floor/plating/asteroid/basalt/lava_land_surface,
/area/lavaland/surface/outdoors)
"ar" = (
/turf/open/floor/plating/asteroid/basalt/lava_land_surface,
/area/overmap_encounter/planetoid/cave/explored)
"as" = (
/obj/effect/decal/cleanable/blood,
/mob/living/simple_animal/hostile/asteroid/hivelord/legion,
/turf/open/floor/plating/asteroid/basalt/lava_land_surface,
/area/overmap_encounter/planetoid/cave/explored)
"at" = (
/obj/item/stack/tile/mineral/plastitanium/red,
/turf/open/floor/plating,
/area/lavaland/surface/outdoors)
"au" = (
/obj/structure/window/reinforced/tinted,
/obj/structure/closet/crate{
	name = "emergency supplies"
	},
/obj/item/pickaxe/emergency,
/obj/item/storage/firstaid/medical,
/obj/item/storage/toolbox/emergency,
/obj/item/flashlight/flare,
/turf/open/floor/mineral/titanium,
/area/lavaland/surface/outdoors)
"av" = (
/obj/structure/closet/crate/coffin{
	icon_state = "coffinopen";
	opened = 1
	},
/obj/effect/mob_spawn/human/skeleton/alive,
/turf/open/floor/mineral/plastitanium/red,
/area/lavaland/surface/outdoors)
"aw" = (
/obj/structure/chair/comfy/shuttle{
	dir = 4
	},
/obj/effect/decal/cleanable/blood,
/obj/item/stack/tile/mineral/plastitanium/red,
/turf/open/floor/plating,
/area/lavaland/surface/outdoors)
"ax" = (
/obj/structure/closet/crate{
	name = "DANGER: PARANORMAL ARTEFACTS"
	},
/obj/item/reagent_containers/food/snacks/muffin/booberry,
/obj/item/instrument/trombone,
/obj/item/reagent_containers/food/snacks/grown/ghost_chili,
/obj/item/clothing/head/hardhat/pumpkinhead,
/obj/item/nullrod/scythe/talking,
/obj/item/clothing/head/helmet/skull,
/turf/open/floor/mineral/plastitanium/red,
/area/overmap_encounter/planetoid/cave/explored)
"ay" = (
/obj/structure/window/reinforced/tinted,
/obj/structure/closet/crate{
	name = "emergency supplies"
	},
/obj/item/pickaxe/emergency,
/obj/item/storage/firstaid/medical,
/obj/item/storage/toolbox/emergency,
/obj/item/flashlight/flare,
/turf/open/floor/mineral/titanium,
/area/overmap_encounter/planetoid/cave/explored)
"az" = (
/obj/effect/decal/cleanable/glass,
/obj/effect/decal/cleanable/blood/drip,
/turf/open/floor/plating/asteroid/basalt/lava_land_surface,
/area/overmap_encounter/planetoid/cave/explored)
"aA" = (
/obj/effect/decal/cleanable/blood,
/mob/living/simple_animal/hostile/asteroid/hivelord/legion,
/turf/open/floor/plating/asteroid/basalt/lava_land_surface,
/area/lavaland/surface/outdoors)
"aB" = (
/obj/structure/window/reinforced/tinted,
/obj/effect/decal/cleanable/blood,
/obj/structure/bed/dogbed,
/mob/living/simple_animal/pet/dog/pug{
	health = 5;
	name = "Gooby-Moo"
	},
/turf/open/floor/mineral/titanium,
/area/overmap_encounter/planetoid/cave/explored)
"aC" = (
/obj/effect/decal/cleanable/blood/splatter,
/turf/open/floor/mineral/titanium,
/area/lavaland/surface/outdoors)
"aD" = (
/obj/structure/frame/computer,
/obj/item/circuitboard/computer/shuttle/helm,
/obj/item/shard,
/turf/open/floor/mineral/titanium/blue,
/area/lavaland/surface/outdoors)
"aE" = (
/obj/effect/decal/cleanable/blood/drip{
	pixel_y = 10
	},
/turf/open/floor/plating/asteroid/basalt/lava_land_surface,
/area/lavaland/surface/outdoors)
"aF" = (
/turf/open/floor/plating/asteroid/basalt/lava_land_surface,
/area/lavaland/surface/outdoors)
"aG" = (
/obj/machinery/light/broken{
	dir = 1
	},
/obj/effect/decal/cleanable/blood/splatter,
/obj/structure/chair/comfy/shuttle{
	dir = 4
	},
/turf/open/floor/mineral/plastitanium/red,
/area/lavaland/surface/outdoors)
"aH" = (
/turf/closed/wall/mineral/titanium,
/area/overmap_encounter/planetoid/cave/explored)
"aI" = (
/obj/effect/mob_spawn/human/corpse/damaged,
/obj/effect/decal/cleanable/blood,
/obj/item/clothing/suit/armor/riot/knight/red,
/obj/item/clothing/head/helmet/knight/red,
/obj/item/claymore/weak{
	desc = "Comically rusted to the point of near uselessness.";
	force = 6;
	name = "rusted claymore"
	},
/turf/open/floor/mineral/plastitanium/red,
/area/lavaland/surface/outdoors)
"aJ" = (
/obj/structure/girder/displaced,
/obj/item/stack/sheet/mineral/titanium,
/turf/open/floor/plating,
/area/lavaland/surface/outdoors)
"aK" = (
/obj/effect/decal/cleanable/glass,
/obj/effect/decal/cleanable/blood/drip,
/turf/open/floor/plating/asteroid/basalt/lava_land_surface,
/area/lavaland/surface/outdoors)
"aL" = (
/obj/item/grenade/chem_grenade/ghostbuster,
/turf/open/floor/mineral/titanium,
/area/lavaland/surface/outdoors)
"aM" = (
/obj/structure/table,
/obj/item/paper/crumpled{
	info = "Objective is to locate and secure the reliquary holding the supernatural items, then swing them back to HQ for containment. Simple job for Mystery Inc.";
	name = "Mission Statement";
	pixel_x = -5
	},
/obj/item/toy/figure/chaplain{
	pixel_x = 6
	},
/turf/open/floor/mineral/titanium/blue,
/area/lavaland/surface/outdoors)
"aN" = (
/obj/effect/spawner/structure/window/shuttle,
/obj/structure/grille,
/turf/open/floor/plating,
/area/lavaland/surface/outdoors)
"aO" = (
/obj/effect/mob_spawn/human/corpse/damaged,
/obj/item/clothing/shoes/jackboots,
/obj/item/clothing/under/color/khaki/buster,
/obj/item/clothing/glasses/welding/ghostbuster,
/obj/effect/decal/cleanable/blood,
/turf/open/floor/mineral/plastitanium/red,
/area/lavaland/surface/outdoors)
"aP" = (
/obj/machinery/power/smes/shuttle,
/obj/structure/window/reinforced/tinted,
/turf/open/floor/mineral/titanium,
/area/overmap_encounter/planetoid/cave/explored)
"aQ" = (
/obj/structure/girder,
/obj/item/stack/sheet/mineral/titanium,
/turf/open/floor/plating,
/area/lavaland/surface/outdoors)
"aR" = (
/obj/machinery/power/smes/shuttle,
/obj/structure/window/reinforced/tinted,
/turf/open/floor/mineral/titanium,
/area/lavaland/surface/outdoors)
"aS" = (
/turf/closed/mineral/random/volcanic,
/area/overmap_encounter/planetoid/cave/explored)
"aT" = (
/obj/structure/window/reinforced/tinted,
/obj/effect/decal/cleanable/blood,
/obj/structure/bed/dogbed,
/mob/living/simple_animal/pet/dog/pug{
	health = 5;
	name = "Gooby-Moo"
	},
/turf/open/floor/mineral/titanium,
/area/lavaland/surface/outdoors)
"aU" = (
/obj/effect/decal/cleanable/blood,
/turf/open/floor/mineral/plastitanium/red,
/area/lavaland/surface/outdoors)
"aV" = (
/obj/structure/closet/crate{
	name = "DANGER: PARANORMAL ARTEFACTS"
	},
/obj/item/reagent_containers/food/snacks/muffin/booberry,
/obj/item/instrument/trombone,
/obj/item/reagent_containers/food/snacks/grown/ghost_chili,
/obj/item/clothing/head/hardhat/pumpkinhead,
/obj/item/nullrod/scythe/talking,
/obj/item/clothing/head/helmet/skull,
/turf/open/floor/mineral/plastitanium/red,
/area/lavaland/surface/outdoors)
"aW" = (
/obj/machinery/door/airlock/shuttle,
/obj/effect/mapping_helpers/airlock/locked,
/turf/open/floor/mineral/titanium/blue,
/area/lavaland/surface/outdoors)
"aX" = (
/obj/structure/chair/comfy/shuttle{
	dir = 1
	},
/obj/effect/mob_spawn/human/corpse/damaged,
/obj/item/clothing/under/rank/civilian/chaplain,
/obj/item/clothing/suit/chaplainsuit/witchhunter,
/obj/item/clothing/head/helmet/chaplain/witchunter_hat,
/obj/effect/decal/cleanable/blood,
/obj/effect/decal/cleanable/glass,
/turf/open/floor/mineral/titanium/blue,
/area/lavaland/surface/outdoors)
"aY" = (
/obj/structure/chair/comfy/shuttle{
	dir = 4
	},
/obj/effect/decal/cleanable/blood/splatter,
/turf/open/floor/mineral/plastitanium/red,
/area/lavaland/surface/outdoors)
"aZ" = (
/obj/machinery/door/airlock/shuttle,
/obj/structure/fans/tiny,
/turf/open/floor/mineral/plastitanium/red,
/area/lavaland/surface/outdoors)
"bw" = (
/obj/item/ectoplasm,
/obj/effect/decal/cleanable/blood/drip{
	pixel_x = 11;
	pixel_y = -3
	},
/turf/open/floor/mineral/titanium,
/area/overmap_encounter/planetoid/cave/explored)
"bQ" = (
/obj/effect/mob_spawn/human/corpse/damaged,
/obj/effect/decal/cleanable/blood,
/obj/item/clothing/suit/armor/riot/knight/red,
/obj/item/clothing/head/helmet/knight/red,
/obj/item/claymore/weak{
	desc = "Comically rusted to the point of near uselessness.";
	force = 6;
	name = "rusted claymore"
	},
/turf/open/floor/mineral/plastitanium/red,
/area/overmap_encounter/planetoid/cave/explored)
"fN" = (
/obj/machinery/door/airlock/shuttle,
/obj/effect/mapping_helpers/airlock/locked,
/turf/open/floor/mineral/titanium/blue,
/area/overmap_encounter/planetoid/cave/explored)
"hs" = (
/obj/structure/girder/displaced,
/obj/item/stack/sheet/mineral/titanium,
/turf/open/floor/plating,
/area/overmap_encounter/planetoid/cave/explored)
"hL" = (
/obj/item/stack/tile/mineral/plastitanium/red,
/turf/open/floor/plating,
/area/overmap_encounter/planetoid/cave/explored)
"jw" = (
/obj/machinery/light/broken/directional/north,
/obj/effect/decal/cleanable/blood/splatter,
/obj/structure/chair/comfy/shuttle{
	dir = 4
	},
/turf/open/floor/mineral/plastitanium/red,
/area/overmap_encounter/planetoid/cave/explored)
"kA" = (
/obj/structure/frame/computer,
/obj/item/circuitboard/computer/shuttle/helm,
/obj/item/shard,
/turf/open/floor/mineral/titanium/blue,
/area/overmap_encounter/planetoid/cave/explored)
"mL" = (
/obj/structure/chair/comfy/shuttle{
	dir = 1
	},
/obj/effect/mob_spawn/human/corpse/damaged,
/obj/item/clothing/under/rank/civilian/chaplain,
/obj/item/clothing/suit/chaplainsuit/witchhunter,
/obj/item/clothing/head/helmet/chaplain/witchunter_hat,
/obj/effect/decal/cleanable/blood,
/obj/effect/decal/cleanable/glass,
/turf/open/floor/mineral/titanium/blue,
/area/overmap_encounter/planetoid/cave/explored)
"mR" = (
/obj/structure/chair/comfy/shuttle{
	dir = 4
	},
/obj/effect/decal/cleanable/blood/splatter,
/turf/open/floor/mineral/plastitanium/red,
/area/overmap_encounter/planetoid/cave/explored)
"nA" = (
/obj/structure/chair/comfy/shuttle{
	dir = 4
	},
/obj/effect/decal/cleanable/blood,
/obj/item/stack/tile/mineral/plastitanium/red,
/turf/open/floor/plating,
/area/overmap_encounter/planetoid/cave/explored)
"pV" = (
/obj/effect/spawner/structure/window/shuttle,
/obj/structure/grille,
/turf/open/floor/plating,
/area/overmap_encounter/planetoid/cave/explored)
"qM" = (
/obj/structure/closet/crate/coffin{
	icon_state = "coffinopen";
	opened = 1
	},
/turf/open/floor/mineral/plastitanium/red,
/area/overmap_encounter/planetoid/cave/explored)
"ro" = (
/obj/structure/grille/broken,
/obj/effect/decal/cleanable/glass,
/obj/item/shard,
/turf/open/floor/plating,
/area/overmap_encounter/planetoid/cave/explored)
"uw" = (
/obj/effect/mob_spawn/human/corpse/damaged,
/obj/item/clothing/shoes/jackboots,
/obj/item/clothing/under/color/khaki/buster,
/obj/item/clothing/glasses/welding/ghostbuster,
/obj/effect/decal/cleanable/blood,
/turf/open/floor/mineral/plastitanium/red,
/area/overmap_encounter/planetoid/cave/explored)
"xX" = (
/obj/effect/decal/cleanable/blood/splatter,
/turf/open/floor/mineral/titanium,
/area/overmap_encounter/planetoid/cave/explored)
"Cs" = (
/obj/effect/decal/cleanable/blood,
/obj/machinery/light/broken/directional/south,
/obj/item/stack/tile/mineral/titanium/blue,
/obj/item/storage/book/bible,
/turf/open/floor/plating,
/area/overmap_encounter/planetoid/cave/explored)
"CI" = (
/obj/item/stack/tile/mineral/titanium,
/turf/open/floor/plating,
/area/overmap_encounter/planetoid/cave/explored)
"Ds" = (
/obj/item/stack/tile/mineral/plastitanium/red,
/obj/effect/decal/cleanable/blood/drip{
	pixel_y = -3
	},
/turf/open/floor/plating,
/area/overmap_encounter/planetoid/cave/explored)
"EK" = (
/obj/effect/decal/cleanable/blood/gibs,
/turf/open/floor/mineral/plastitanium/red,
/area/overmap_encounter/planetoid/cave/explored)
"Hn" = (
/obj/effect/decal/cleanable/blood,
/turf/open/floor/mineral/plastitanium/red,
/area/overmap_encounter/planetoid/cave/explored)
"Jk" = (
/obj/item/grenade/chem_grenade/ghostbuster,
/turf/open/floor/mineral/titanium,
/area/overmap_encounter/planetoid/cave/explored)
"Jq" = (
/obj/structure/table,
/obj/item/paper/crumpled{
	info = "Objective is to locate and secure the reliquary holding the supernatural items, then swing them back to HQ for containment. Simple job for Mystery Inc.";
	name = "Mission Statement";
	pixel_x = -5
	},
/obj/item/toy/figure/chaplain{
	pixel_x = 6
	},
/turf/open/floor/mineral/titanium/blue,
/area/overmap_encounter/planetoid/cave/explored)
"LG" = (
/obj/structure/girder,
/obj/item/stack/sheet/mineral/titanium,
/turf/open/floor/plating,
/area/overmap_encounter/planetoid/cave/explored)
"Pk" = (
/obj/machinery/door/airlock/shuttle,
/obj/structure/fans/tiny,
/turf/open/floor/mineral/plastitanium/red,
/area/overmap_encounter/planetoid/cave/explored)
"UF" = (
/obj/effect/decal/cleanable/blood,
/obj/effect/decal/cleanable/glass,
/obj/item/stack/rods,
/obj/item/stack/tile/mineral/titanium/blue,
/turf/open/floor/plating,
/area/overmap_encounter/planetoid/cave/explored)
"Vw" = (
/obj/structure/table,
/obj/item/soulstone/anybody,
/obj/item/toy/plush/narplush,
/obj/machinery/light/broken/directional/north,
/obj/structure/window/reinforced/spawner,
/obj/machinery/door/window/brigdoor/westright,
/obj/item/clothing/head/wizard/black,
/obj/item/clothing/suit/wizrobe/black,
/turf/open/floor/mineral/plastitanium/red,
/area/overmap_encounter/planetoid/cave/explored)

(1,1,1) = {"
aS
aS
aS
aS
aS
aS
aS
aS
ar
ar
ar
ar
ar
ar
aS
aS
"}
(2,1,1) = {"
aS
aS
aS
aS
aS
aS
aS
aS
aS
aS
ar
ar
ar
ar
aS
aS
"}
(3,1,1) = {"
aS
aS
aS
aS
aS
aS
aS
LG
aH
aH
aH
ar
ar
ar
ar
as
"}
(4,1,1) = {"
aS
aS
aH
aS
aH
aH
jw
nA
mR
ax
aP
af
ar
ar
ap
aS
"}
(5,1,1) = {"
aS
aS
pV
Jq
Cs
aH
uw
Hn
Hn
EK
ay
ar
ar
ar
ar
aS
"}
(6,1,1) = {"
aS
aS
ro
kA
mL
fN
Jk
bw
xX
CI
aB
ar
ar
ag
ar
aS
"}
(7,1,1) = {"
aS
aS
aS
aS
UF
hs
hL
Hn
Ds
bQ
ai
az
ar
ar
ar
aS
"}
(8,1,1) = {"
aS
aS
aS
aH
aH
aH
Vw
EK
qM
qM
aP
af
ar
ar
ar
ar
"}
(9,1,1) = {"
aS
aS
aS
aS
aS
aH
aH
Pk
aH
aH
aH
ar
ar
ar
ar
ar
"}
(10,1,1) = {"
aS
aS
aS
aS
aS
aS
aS
aS
aS
aS
ar
ar
ar
ar
ar
aS
"}
(11,1,1) = {"
aS
aS
aS
aS
aS
aS
aS
aS
ar
ar
ar
ar
ar
ar
ar
ar
"}
