//MAP CONVERTED BY dmm2tgm.py THIS HEADER COMMENT PREVENTS RECONVERSION, DO NOT REMOVE
"ai" = (
/obj/structure/flora/grass/both,
/obj/effect/decal/remains/human,
/turf/open/floor/plating/asteroid/snow/icemoon,
/area/overmap_encounter/planetoid/cave/explored)
"ay" = (
/turf/open/floor/carpet,
/area/ruin/powered)
"aH" = (
/obj/structure/sign/poster/ripped,
/turf/closed/wall/rust,
/area/overmap_encounter/planetoid/cave/explored)
"aM" = (
/turf/open/floor/wood,
/area/ruin/powered)
"aP" = (
/obj/structure/dresser,
/turf/open/floor/wood,
/area/ruin/powered)
"bJ" = (
/obj/structure/flora/grass/both,
/turf/open/floor/plating/asteroid/snow/icemoon,
/area/overmap_encounter/planetoid/cave/explored)
"bP" = (
/obj/machinery/door/airlock/maintenance_hatch{
	dir = 4
	},
/turf/open/floor/plating,
/area/ruin/powered)
"ca" = (
/obj/structure/fence/cut/medium{
	dir = 4
	},
/turf/open/floor/plating/asteroid/snow/icemoon,
/area/overmap_encounter/planetoid/cave/explored)
"cj" = (
/obj/structure/table,
/obj/item/reagent_containers/food/snacks/fishandchips,
/obj/effect/turf_decal/corner/opaque/black{
	dir = 1
	},
/obj/effect/turf_decal/corner/opaque/black{
	dir = 2
	},
/turf/open/floor/plasteel,
/area/ruin/powered)
"co" = (
/obj/machinery/light/small/broken/directional/east,
/obj/structure/fluff/fokoff_sign,
/turf/open/floor/plating/asteroid/snow/icemoon,
/area/overmap_encounter/planetoid/cave/explored)
"cB" = (
/obj/effect/decal/cleanable/blood,
/turf/open/floor/wood,
/area/ruin/powered)
"db" = (
/obj/structure/flora/rock/pile/icy,
/turf/open/floor/plating/asteroid/snow/icemoon,
/area/overmap_encounter/planetoid/cave/explored)
"dh" = (
/obj/machinery/door/airlock/wood,
/obj/structure/barricade/wooden/crude/snow,
/turf/open/floor/wood,
/area/ruin/powered)
"eQ" = (
/obj/structure/fence{
	dir = 8
	},
/turf/open/floor/plating/asteroid/snow/icemoon,
/area/overmap_encounter/planetoid/cave/explored)
"eX" = (
/turf/open/floor/plating/ice/icemoon,
/area/overmap_encounter/planetoid/cave/explored)
"fQ" = (
/obj/structure/showcase/machinery/tv,
/obj/effect/decal/cleanable/dirt,
/obj/machinery/light/broken/directional/north,
/turf/open/floor/holofloor/wood,
/area/ruin/powered)
"gG" = (
/obj/structure/table/wood,
/obj/item/reagent_containers/food/snacks/sashimi{
	pixel_y = 10
	},
/obj/item/reagent_containers/food/drinks/mug/coco{
	pixel_x = -10
	},
/obj/item/reagent_containers/food/drinks/mug/coco{
	pixel_x = 10;
	pixel_y = -4
	},
/obj/effect/decal/cleanable/dirt,
/turf/open/floor/carpet,
/area/ruin/powered)
"gK" = (
/obj/structure/flora/rock/icy,
/turf/open/floor/plating/asteroid/snow/icemoon,
/area/overmap_encounter/planetoid/cave/explored)
"hD" = (
/obj/effect/decal/cleanable/blood/gibs/limb,
/turf/open/floor/engine/cult,
/area/ruin/powered)
"jk" = (
/obj/effect/decal/cleanable/dirt,
/turf/open/floor/wood,
/area/ruin/powered)
"li" = (
/obj/structure/dresser,
/obj/effect/decal/cleanable/glass,
/turf/open/floor/wood,
/area/ruin/powered)
"lk" = (
/turf/open/floor/plating/asteroid/snow/ice/icemoon,
/area/overmap_encounter/planetoid/cave/explored)
"mi" = (
/obj/effect/decal/remains/human,
/mob/living/simple_animal/hostile/construct/juggernaut/hostile{
	health = 450;
	maxHealth = 450;
	name = "Right Hand of the Elder"
	},
/turf/open/floor/engine/cult,
/area/ruin/powered)
"mj" = (
/obj/machinery/light/small/directional/east,
/turf/open/floor/plating/asteroid/snow/icemoon,
/area/overmap_encounter/planetoid/cave/explored)
"nA" = (
/obj/effect/decal/cleanable/blood/drip,
/obj/structure/fence/door,
/turf/open/floor/plating/asteroid/snow/icemoon,
/area/overmap_encounter/planetoid/cave/explored)
"nF" = (
/obj/effect/decal/cleanable/blood/splatter,
/obj/effect/decal/cleanable/blood/footprints{
	dir = 8
	},
/turf/open/floor/plating/asteroid/snow/icemoon,
/area/overmap_encounter/planetoid/cave/explored)
"oB" = (
/obj/structure/table/wood,
/obj/structure/bedsheetbin/empty,
/obj/item/clothing/under/misc/pj/blue,
/obj/item/clothing/shoes/sneakers/white,
/turf/open/floor/wood,
/area/ruin/powered)
"oJ" = (
/obj/structure/flora/grass/brown,
/turf/open/floor/plating/asteroid/snow/icemoon,
/area/overmap_encounter/planetoid/cave/explored)
"pH" = (
/obj/structure/sign/poster/official/work_for_a_future,
/turf/closed/wall/mineral/wood,
/area/ruin/powered)
"pP" = (
/obj/structure/chair/sofa/left{
	dir = 1
	},
/obj/effect/decal/cleanable/dirt,
/turf/open/floor/wood,
/area/ruin/powered)
"rj" = (
/obj/item/reagent_containers/food/drinks/beer,
/turf/open/floor/plating/ice/icemoon,
/area/overmap_encounter/planetoid/cave/explored)
"sm" = (
/turf/closed/mineral/random/snow,
/area/overmap_encounter/planetoid/cave/explored)
"sG" = (
/obj/effect/decal/cleanable/vomit,
/obj/structure/toilet{
	dir = 1
	},
/turf/open/floor/plating,
/area/ruin/powered)
"sH" = (
/obj/structure/flora/ausbushes/sparsegrass,
/turf/open/floor/plating/asteroid/snow/icemoon,
/area/overmap_encounter/planetoid/cave/explored)
"sY" = (
/obj/structure/sink/kitchen{
	dir = 4;
	pixel_x = -12
	},
/obj/effect/decal/cleanable/dirt,
/obj/effect/turf_decal/corner/opaque/black{
	dir = 1
	},
/obj/effect/turf_decal/corner/opaque/black{
	dir = 2
	},
/turf/open/floor/plasteel,
/area/ruin/powered)
"tt" = (
/obj/effect/decal/cleanable/dirt,
/turf/open/floor/plasteel/freezer,
/area/ruin/powered)
"tO" = (
/turf/closed/mineral/snowmountain/cavern/icemoon,
/area/overmap_encounter/planetoid/cave/explored)
"tU" = (
/obj/structure/bed,
/obj/effect/decal/cleanable/blood/bubblegum,
/obj/item/bedsheet/dorms,
/turf/open/floor/wood,
/area/ruin/powered)
"tX" = (
/obj/structure/table/wood,
/obj/structure/bedsheetbin,
/turf/open/floor/wood,
/area/ruin/powered)
"ut" = (
/obj/item/flashlight/lantern{
	on = 1
	},
/obj/effect/decal/cleanable/dirt,
/turf/open/floor/wood,
/area/ruin/powered)
"vp" = (
/obj/structure/fence/door/opened{
	dir = 8
	},
/turf/open/floor/plating/snowed/smoothed/icemoon,
/area/overmap_encounter/planetoid/cave/explored)
"wo" = (
/obj/structure/closet/crate/trashcart,
/obj/effect/decal/cleanable/dirt,
/obj/effect/decal/cleanable/blood,
/obj/item/bodypart/head,
/obj/item/bodypart/l_arm{
	pixel_x = -9;
	pixel_y = -9
	},
/obj/item/bodypart/leg/left,
/obj/item/bodypart/r_arm,
/obj/item/bodypart/leg/right{
	pixel_x = 8;
	pixel_y = 4
	},
/obj/item/bodypart/chest,
/obj/item/organ/heart,
/obj/item/multitool,
/turf/open/floor/plasteel/freezer,
/area/ruin/powered)
"wQ" = (
/turf/closed/wall,
/area/ruin/powered)
"xN" = (
/obj/structure/bed/dogbed{
	pixel_y = 14
	},
/obj/effect/decal/cleanable/dirt,
/turf/open/floor/carpet,
/area/ruin/powered)
"yb" = (
/obj/structure/chair/sofa/right{
	dir = 1
	},
/turf/open/floor/wood,
/area/ruin/powered)
"zk" = (
/obj/structure/fence,
/turf/open/floor/plating/asteroid/snow/icemoon,
/area/overmap_encounter/planetoid/cave/explored)
"zR" = (
/obj/machinery/door/airlock/wood,
/obj/effect/decal/cleanable/dirt,
/turf/open/floor/wood,
/area/ruin/powered)
"AM" = (
/obj/effect/decal/cleanable/blood/gibs/down,
/obj/item/pickaxe,
/turf/open/floor/engine/cult,
/area/ruin/powered)
"AN" = (
/obj/structure/closet/cabinet,
/obj/item/restraints/legcuffs/beartrap,
/obj/item/restraints/legcuffs/beartrap,
/obj/item/reagent_containers/glass/bottle/venom,
/obj/item/reagent_containers/glass/bottle/curare,
/obj/item/kitchen/knife/combat/survival,
/obj/effect/decal/cleanable/dirt,
/obj/item/reagent_containers/food/snacks/meat/slab/human,
/obj/item/reagent_containers/food/snacks/meat/slab/human,
/obj/item/reagent_containers/food/snacks/meat/slab/human,
/turf/open/floor/wood,
/area/ruin/powered)
"AP" = (
/obj/structure/flora/bush,
/turf/open/floor/plating/asteroid/snow/icemoon,
/area/overmap_encounter/planetoid/cave/explored)
"Cd" = (
/obj/structure/chair/comfy/brown{
	dir = 8
	},
/turf/open/floor/carpet,
/area/ruin/powered)
"Cj" = (
/obj/structure/chair/sofa/left,
/turf/closed/mineral/random/snow,
/area/overmap_encounter/planetoid/cave/explored)
"Cl" = (
/obj/structure/sacrificealtar,
/obj/effect/decal/cleanable/blood/old,
/obj/item/kitchen/knife/bloodletter,
/turf/open/floor/engine/cult,
/area/ruin/powered)
"Do" = (
/obj/structure/flora/ausbushes/fullgrass,
/obj/structure/flora/grass/both,
/obj/structure/fence{
	dir = 8
	},
/turf/open/floor/plating/asteroid/snow/icemoon,
/area/overmap_encounter/planetoid/cave/explored)
"DI" = (
/obj/structure/closet/emcloset,
/obj/item/tank/internals/emergency_oxygen,
/obj/item/tank/internals/emergency_oxygen,
/obj/item/clothing/mask/breath/medical,
/obj/item/clothing/mask/breath/medical,
/obj/item/flashlight/lantern,
/turf/open/floor/plasteel/freezer,
/area/ruin/powered)
"Ed" = (
/obj/machinery/door/airlock/wood,
/obj/effect/mapping_helpers/airlock/locked,
/obj/structure/barricade/wooden/crude,
/turf/open/floor/wood,
/area/ruin/powered)
"Er" = (
/obj/structure/flora/stump,
/turf/open/floor/plating/asteroid/snow/icemoon,
/area/overmap_encounter/planetoid/cave/explored)
"EF" = (
/obj/effect/decal/cleanable/blood/gibs/torso,
/obj/effect/decal/remains/human,
/mob/living/simple_animal/hostile/construct/juggernaut/hostile{
	health = 450;
	maxHealth = 450;
	name = "Left Hand of the Elder"
	},
/turf/open/floor/engine/cult,
/area/ruin/powered)
"Fa" = (
/obj/structure/sign/poster/official/nanotrasen_logo,
/turf/closed/wall,
/area/overmap_encounter/planetoid/cave/explored)
"Fb" = (
/obj/structure/closet/secure_closet/freezer,
/obj/item/reagent_containers/food/snacks/fishmeat/carp,
/obj/item/reagent_containers/food/snacks/fishmeat/carp,
/obj/item/reagent_containers/food/snacks/fishmeat/carp,
/obj/item/reagent_containers/food/condiment/pack/ketchup,
/obj/item/reagent_containers/food/condiment/pack/ketchup,
/obj/item/reagent_containers/food/condiment/pack/ketchup,
/obj/effect/turf_decal/corner/opaque/black{
	dir = 1
	},
/obj/effect/turf_decal/corner/opaque/black{
	dir = 2
	},
/turf/open/floor/plasteel,
/area/ruin/powered)
"Gr" = (
/obj/structure/closet/crate/trashcart,
/obj/effect/decal/cleanable/dirt,
/obj/item/trash/chips,
/obj/item/trash/semki{
	pixel_x = 8;
	pixel_y = -4
	},
/obj/item/clothing/neck/petcollar,
/turf/open/floor/plasteel/freezer,
/area/ruin/powered)
"Gy" = (
/obj/effect/decal/cleanable/dirt,
/obj/machinery/door/airlock/wood,
/turf/open/floor/plating,
/area/ruin/powered)
"GK" = (
/obj/item/clothing/head/bearpelt,
/obj/structure/table/wood,
/obj/item/reagent_containers/food/snacks/burger/fish,
/obj/item/reagent_containers/food/drinks/beer{
	pixel_x = -4
	},
/obj/item/reagent_containers/food/drinks/beer{
	pixel_x = 10;
	pixel_y = 6
	},
/turf/open/floor/wood,
/area/ruin/powered)
"GY" = (
/obj/effect/decal/cleanable/blood/footprints{
	dir = 1
	},
/obj/item/restraints/legcuffs/beartrap{
	armed = 1
	},
/obj/structure/flora/grass/both,
/turf/open/floor/plating/asteroid/snow/icemoon,
/area/overmap_encounter/planetoid/cave/explored)
"Ha" = (
/obj/structure/mirror{
	broken = 1
	},
/turf/closed/wall/mineral/wood,
/area/ruin/powered)
"Hf" = (
/obj/effect/decal/cleanable/blood/drip,
/turf/open/floor/wood,
/area/ruin/powered)
"Hx" = (
/obj/structure/closet/cabinet,
/obj/item/clothing/under/rank/cargo/miner,
/obj/item/clothing/suit/hooded/wintercoat/miner,
/obj/item/clothing/shoes/winterboots,
/obj/item/card/id/mining,
/obj/effect/decal/cleanable/dirt,
/turf/open/floor/wood,
/area/ruin/powered)
"IA" = (
/obj/structure/fireplace{
	fuel_added = 1000;
	lit = 1
	},
/obj/effect/decal/cleanable/dirt,
/turf/open/floor/carpet,
/area/ruin/powered)
"II" = (
/obj/structure/flora/rock/icy,
/obj/effect/mob_spawn/human/corpse/assistant,
/turf/open/floor/plating/asteroid/snow/icemoon,
/area/overmap_encounter/planetoid/cave/explored)
"Jc" = (
/obj/effect/decal/cleanable/blood/splatter,
/turf/open/floor/plating/snowed/smoothed/icemoon,
/area/overmap_encounter/planetoid/cave/explored)
"Js" = (
/obj/effect/decal/cleanable/blood/tracks,
/obj/effect/decal/cleanable/blood/footprints{
	dir = 1
	},
/turf/open/floor/plating/asteroid/snow/icemoon,
/area/overmap_encounter/planetoid/cave/explored)
"JF" = (
/obj/structure/flora/ausbushes/fullgrass,
/turf/open/floor/plating/asteroid/snow/icemoon,
/area/overmap_encounter/planetoid/cave/explored)
"KE" = (
/turf/closed/wall,
/area/overmap_encounter/planetoid/cave/explored)
"Lh" = (
/turf/open/floor/plating/asteroid/snow/icemoon,
/area/overmap_encounter/planetoid/cave/explored)
"Mh" = (
/obj/structure/statue/snow/snowlegion{
	desc = "An off-putting snowman, something about it gives you a sense of dread instead of holiday cheer."
	},
/turf/open/floor/plating/asteroid/snow/icemoon,
/area/overmap_encounter/planetoid/cave/explored)
"Nq" = (
/obj/effect/decal/cleanable/dirt,
/obj/structure/rack,
/obj/item/storage/bag/ore,
/obj/item/storage/toolbox/mechanical,
/turf/open/floor/plasteel/freezer,
/area/ruin/powered)
"Nv" = (
/obj/effect/decal/cleanable/blood/gibs/up,
/obj/effect/mob_spawn/human/corpse/assistant,
/mob/living/simple_animal/hostile/skeleton/eskimo{
	name = "Village Hunter"
	},
/turf/open/floor/plating/asteroid/snow/icemoon,
/area/overmap_encounter/planetoid/cave/explored)
"NJ" = (
/obj/machinery/door/airlock/wood{
	dir = 8
	},
/turf/open/floor/wood,
/area/ruin/powered)
"Os" = (
/obj/structure/chair/comfy/brown{
	dir = 4
	},
/turf/open/floor/carpet,
/area/ruin/powered)
"Pp" = (
/obj/machinery/vending/snack/random,
/turf/open/floor/holofloor/wood,
/area/ruin/powered)
"PQ" = (
/obj/effect/decal/cleanable/blood/splatter,
/mob/living/simple_animal/hostile/illusion{
	deathmessage = "disperses into the air in a cloud of red mist, you feel slightly more at ease.";
	desc = "You can't quite make out what you're seeing.";
	faction = list("cult");
	health = 500;
	maxHealth = 500;
	melee_damage_lower = 10;
	melee_damage_upper = 30;
	name = "Village Elder"
	},
/turf/open/floor/engine/cult,
/area/ruin/powered)
"PV" = (
/obj/structure/flora/grass/green,
/turf/open/floor/plating/asteroid/snow/icemoon,
/area/overmap_encounter/planetoid/cave/explored)
"PZ" = (
/turf/closed/mineral/ice,
/area/overmap_encounter/planetoid/cave/explored)
"QB" = (
/obj/structure/chair/wood{
	dir = 4
	},
/turf/open/floor/plating/ice/icemoon,
/area/overmap_encounter/planetoid/cave/explored)
"QK" = (
/obj/structure/bed,
/obj/item/bedsheet/dorms,
/turf/open/floor/wood,
/area/ruin/powered)
"QR" = (
/turf/closed/wall/rust,
/area/ruin/powered)
"Si" = (
/obj/structure/mirror,
/turf/closed/wall/mineral/wood,
/area/ruin/powered)
"SN" = (
/turf/open/floor/plasteel/freezer,
/area/ruin/powered)
"SZ" = (
/obj/machinery/door/airlock/wood,
/turf/open/floor/wood,
/area/ruin/powered)
"UI" = (
/obj/machinery/washing_machine,
/obj/effect/decal/cleanable/blood,
/obj/item/reagent_containers/food/snacks/meat/slab/corgi,
/turf/open/floor/wood,
/area/ruin/powered)
"UR" = (
/turf/open/floor/plating/snowed/smoothed/icemoon,
/area/overmap_encounter/planetoid/cave/explored)
"Vn" = (
/turf/closed/wall/mineral/wood,
/area/ruin/powered)
"VB" = (
/obj/structure/flora/tree/pine,
/turf/open/floor/plating/asteroid/snow/icemoon,
/area/overmap_encounter/planetoid/cave/explored)
"WH" = (
/obj/effect/decal/cleanable/dirt,
/obj/structure/bed,
/obj/item/bedsheet/cult,
/turf/open/floor/wood,
/area/ruin/powered)
"Yq" = (
/obj/structure/flora/ausbushes/fullgrass,
/obj/structure/flora/grass/both,
/turf/open/floor/plating/asteroid/snow/icemoon,
/area/overmap_encounter/planetoid/cave/explored)
"YD" = (
/obj/effect/decal/cleanable/blood/tracks{
	dir = 4
	},
/obj/effect/decal/cleanable/blood/footprints{
	dir = 8
	},
/turf/open/floor/plating/asteroid/snow/icemoon,
/area/overmap_encounter/planetoid/cave/explored)
"ZD" = (
/obj/effect/decal/cleanable/blood/drip,
/turf/open/floor/plating/asteroid/snow/icemoon,
/area/overmap_encounter/planetoid/cave/explored)
"ZG" = (
/obj/effect/decal/cleanable/dirt,
/obj/structure/closet/cabinet,
/obj/item/clothing/suit/hooded/wintercoat,
/obj/item/clothing/shoes/winterboots,
/obj/item/clothing/under/suit/tan,
/turf/open/floor/wood,
/area/ruin/powered)

(1,1,1) = {"
sm
sm
sm
sm
sm
sm
sm
sm
sm
sm
sm
sm
sm
sm
sm
sm
sm
sm
sm
sm
sm
sm
sm
sm
sm
sm
sm
sm
"}
(2,1,1) = {"
sm
sm
sm
sm
lk
Lh
Lh
co
Lh
Lh
Lh
mj
Lh
Lh
Lh
bJ
Lh
Lh
Lh
Lh
Lh
Lh
Lh
sm
sm
sm
sm
sm
"}
(3,1,1) = {"
sm
sm
sm
eX
lk
Lh
Lh
aH
db
PZ
Lh
Fa
Lh
Lh
Lh
Lh
Lh
Lh
db
Lh
Lh
Lh
Lh
Lh
Er
sm
sm
sm
"}
(4,1,1) = {"
sm
sm
sm
lk
Lh
Lh
sm
KE
PZ
II
PZ
KE
sm
sm
sm
sm
sm
sm
sm
sm
JF
lk
lk
Lh
Lh
lk
sm
sm
"}
(5,1,1) = {"
sm
sm
Lh
Lh
Lh
bJ
sm
sm
PZ
Jc
db
sm
sm
Vn
Vn
Vn
sm
sm
sm
sm
sm
sm
sm
lk
Lh
Lh
Lh
sm
"}
(6,1,1) = {"
sm
db
Lh
Lh
Er
sm
sm
sm
db
UR
UR
UR
sm
Vn
UI
Vn
Vn
wQ
wQ
QR
QR
wQ
sm
sm
Lh
bJ
Lh
sm
"}
(7,1,1) = {"
sm
Lh
gK
Lh
sm
sm
Vn
Vn
Vn
Vn
Lh
UR
VB
pH
jk
tX
Vn
QR
DI
SN
wo
wQ
sm
sm
gK
Lh
Lh
sm
"}
(8,1,1) = {"
sm
Lh
Lh
Lh
sm
sm
Vn
cj
sY
Vn
Lh
UR
Vn
Vn
jk
oB
Vn
wQ
DI
tt
Gr
QR
ai
sm
sm
Lh
Lh
sm
"}
(9,1,1) = {"
sm
Lh
Lh
sm
sm
Nv
Vn
Fb
ut
Vn
zk
vp
Vn
fQ
aM
yb
Vn
wQ
Nq
SN
QR
QR
Lh
sm
sm
Lh
Lh
sm
"}
(10,1,1) = {"
sm
Lh
PV
sm
sm
YD
Ha
li
Hf
SZ
UR
UR
Vn
Pp
aM
pP
Vn
wQ
QR
bP
wQ
Lh
JF
sm
sm
Lh
Lh
sm
"}
(11,1,1) = {"
sm
Lh
lk
sm
sm
YD
Vn
Hx
tU
Vn
ZD
UR
Vn
Vn
NJ
Vn
Vn
Lh
Lh
UR
eQ
VB
Lh
sm
sm
Lh
Lh
sm
"}
(12,1,1) = {"
sm
Lh
lk
sm
sm
YD
Vn
Vn
Vn
Vn
Lh
UR
Lh
VB
UR
JF
AP
UR
UR
UR
ca
Lh
Lh
sm
sm
sm
Lh
sm
"}
(13,1,1) = {"
sm
Lh
lk
sm
sm
nF
Js
GY
nA
Lh
ZD
UR
UR
UR
UR
Lh
Lh
UR
Lh
Vn
Vn
Vn
Vn
sm
sm
sm
db
sm
"}
(14,1,1) = {"
sm
Lh
sm
sm
sm
tO
VB
sH
Do
Lh
Lh
Lh
Lh
Lh
UR
Lh
Lh
UR
Lh
Vn
QK
AN
Vn
sm
sm
sm
Lh
sm
"}
(15,1,1) = {"
sm
Lh
sm
Vn
Vn
Vn
Vn
Vn
Vn
Vn
Vn
Lh
UR
UR
UR
UR
UR
UR
UR
zR
cB
GK
Vn
sm
sm
Er
Lh
sm
"}
(16,1,1) = {"
sm
Lh
sm
Vn
EF
hD
Si
aP
WH
ZG
Vn
Lh
UR
JF
Lh
Lh
Lh
Lh
Lh
Vn
Vn
Vn
Vn
sm
sm
Lh
Lh
sm
"}
(17,1,1) = {"
sm
Lh
sm
Vn
Cl
PQ
Ed
jk
aM
aM
Vn
Lh
UR
Lh
Lh
Lh
VB
Lh
Lh
Lh
Gy
sG
Vn
sm
sm
Lh
Lh
sm
"}
(18,1,1) = {"
sm
Lh
sm
Vn
mi
AM
Vn
ay
Os
jk
dh
UR
UR
Lh
Lh
Lh
Lh
Yq
Lh
Lh
Vn
Vn
Vn
sm
sm
Lh
Lh
sm
"}
(19,1,1) = {"
sm
Lh
sm
Vn
Vn
Vn
Vn
IA
gG
aM
Vn
Lh
Lh
Lh
lk
oJ
Lh
Lh
Mh
Lh
Lh
Lh
VB
sm
sm
Lh
oJ
sm
"}
(20,1,1) = {"
sm
Lh
sm
sm
sm
Cj
Vn
xN
Cd
jk
Vn
Yq
Lh
lk
eX
lk
lk
Lh
Lh
Lh
Lh
Lh
Lh
sm
sm
Lh
Lh
sm
"}
(21,1,1) = {"
sm
Lh
Lh
sH
sm
sm
Vn
Vn
Vn
Vn
Vn
Lh
oJ
lk
eX
eX
eX
lk
sH
Lh
Lh
AP
sm
sm
sm
Lh
Lh
sm
"}
(22,1,1) = {"
sm
Er
Lh
Lh
sm
sm
sm
sm
VB
Lh
Lh
Lh
lk
eX
rj
QB
eX
eX
lk
lk
Lh
sm
sm
sm
Er
Lh
Lh
sm
"}
(23,1,1) = {"
sm
sm
db
Lh
Lh
sm
sm
sm
sm
AP
JF
lk
lk
eX
eX
eX
eX
eX
eX
sm
sm
sm
sm
Lh
Lh
Lh
Lh
sm
"}
(24,1,1) = {"
sm
sm
sm
lk
Lh
Lh
Lh
sm
sm
sm
sm
sm
sm
eX
eX
eX
eX
eX
sm
sm
sm
sm
db
gK
Lh
Lh
Lh
sm
"}
(25,1,1) = {"
sm
sm
sm
eX
lk
lk
Lh
sm
sm
sm
sm
sm
sm
sm
sm
sm
sm
sm
sm
sm
sm
Lh
Lh
Lh
Lh
Lh
Lh
sm
"}
(26,1,1) = {"
sm
sm
sm
eX
lk
gK
Lh
db
sm
sm
sm
sm
sm
sm
sm
sm
sm
sm
sm
lk
Lh
Lh
Lh
lk
sm
Lh
Lh
sm
"}
(27,1,1) = {"
sm
sm
sm
sm
sm
sm
Lh
Lh
Lh
Lh
Lh
Lh
Lh
db
gK
Lh
Lh
Lh
Lh
Lh
Er
JF
lk
sm
sm
db
Lh
sm
"}
(28,1,1) = {"
sm
sm
sm
sm
sm
sm
sm
sm
sm
sm
sm
sm
sm
sm
sm
sm
sm
sm
sm
sm
sm
sm
sm
sm
sm
sm
sm
sm
"}
