//MAP CONVERTED BY dmm2tgm.py THIS HEADER COMMENT PREVENTS RECONVERSION, DO NOT REMOVE
"ay" = (
/turf/open/floor/carpet,
/area/ruin/powered)
"aA" = (
/turf/open/floor/plating/snowed/smoothed/icemoon,
/area/overmap_encounter/planetoid/cave/explored)
"aH" = (
/obj/effect/decal/cleanable/blood/drip,
/obj/structure/fence/door,
/turf/open/floor/plating/asteroid/snow/icemoon,
/area/overmap_encounter/planetoid/cave/explored)
"aM" = (
/turf/open/floor/wood,
/area/ruin/powered)
"aP" = (
/obj/structure/dresser,
/turf/open/floor/wood,
/area/ruin/powered)
"bz" = (
/obj/structure/flora/rock/icy,
/obj/effect/mob_spawn/human/corpse/assistant,
/turf/open/floor/plating/asteroid/snow/icemoon,
/area/overmap_encounter/planetoid/cave/explored)
"cj" = (
/obj/structure/table,
/obj/item/reagent_containers/food/snacks/fishandchips,
/obj/effect/turf_decal/corner/opaque/black{
	dir = 1
	},
/obj/effect/turf_decal/corner/opaque/black{
	dir = 2
	},
/turf/open/floor/plasteel,
/area/ruin/powered)
"co" = (
/obj/structure/chair/wood{
	dir = 4
	},
/turf/open/floor/plating/ice/icemoon,
/area/overmap_encounter/planetoid/cave/explored)
"cB" = (
/obj/effect/decal/cleanable/blood,
/turf/open/floor/wood,
/area/ruin/powered)
"cL" = (
/obj/machinery/door/airlock/wood{
	dir = 8
	},
/turf/open/floor/wood,
/area/ruin/powered)
"dh" = (
/obj/machinery/door/airlock/wood,
/obj/structure/barricade/wooden/crude/snow,
/turf/open/floor/wood,
/area/ruin/powered)
"fm" = (
/turf/closed/wall,
/area/overmap_encounter/planetoid/cave/explored)
"gG" = (
/obj/structure/table/wood,
/obj/item/reagent_containers/food/snacks/sashimi{
	pixel_y = 10
	},
/obj/item/reagent_containers/food/drinks/mug/coco{
	pixel_x = -10
	},
/obj/item/reagent_containers/food/drinks/mug/coco{
	pixel_x = 10;
	pixel_y = -4
	},
/obj/effect/decal/cleanable/dirt,
/turf/open/floor/carpet,
/area/ruin/powered)
"hm" = (
/obj/structure/statue/snow/snowlegion{
	desc = "An off-putting snowman, something about it gives you a sense of dread instead of holiday cheer."
	},
/turf/open/floor/plating/asteroid/snow/icemoon,
/area/overmap_encounter/planetoid/cave/explored)
"hD" = (
/obj/effect/decal/cleanable/blood/gibs/limb,
/turf/open/floor/engine/cult,
/area/ruin/powered)
"im" = (
/obj/machinery/light/small/broken/directional/east,
/obj/structure/fluff/fokoff_sign,
/turf/open/floor/plating/asteroid/snow/icemoon,
/area/overmap_encounter/planetoid/cave/explored)
"in" = (
/obj/structure/flora/grass/brown,
/turf/open/floor/plating/asteroid/snow/icemoon,
/area/overmap_encounter/planetoid/cave/explored)
"jk" = (
/obj/effect/decal/cleanable/dirt,
/turf/open/floor/wood,
/area/ruin/powered)
"kn" = (
/obj/structure/flora/grass/both,
/turf/open/floor/plating/asteroid/snow/icemoon,
/area/overmap_encounter/planetoid/cave/explored)
"kI" = (
/obj/structure/flora/bush,
/turf/open/floor/plating/asteroid/snow/icemoon,
/area/overmap_encounter/planetoid/cave/explored)
"li" = (
/obj/structure/dresser,
/obj/effect/decal/cleanable/glass,
/turf/open/floor/wood,
/area/ruin/powered)
"lD" = (
/obj/structure/closet/crate/trashcart,
/obj/effect/decal/cleanable/dirt,
/obj/effect/decal/cleanable/blood,
/obj/item/bodypart/head,
/obj/item/bodypart/l_arm{
	pixel_x = -9;
	pixel_y = -9
	},
/obj/item/bodypart/leg/left,
/obj/item/bodypart/r_arm,
/obj/item/bodypart/leg/right{
	pixel_x = 8;
	pixel_y = 4
	},
/obj/item/bodypart/chest,
/obj/item/organ/heart,
/obj/item/multitool,
/turf/open/floor/plasteel/freezer,
/area/ruin/powered)
"me" = (
/turf/open/floor/plating/asteroid/snow/icemoon,
/area/overmap_encounter/planetoid/cave/explored)
"mi" = (
/obj/effect/decal/remains/human,
/mob/living/simple_animal/hostile/construct/juggernaut/hostile{
	health = 450;
	maxHealth = 450;
	name = "Right Hand of the Elder"
	},
/turf/open/floor/engine/cult,
/area/ruin/powered)
"ne" = (
/turf/closed/mineral/random/snow,
/area/overmap_encounter/planetoid/cave/explored)
"nE" = (
/obj/structure/flora/grass/green,
/turf/open/floor/plating/asteroid/snow/icemoon,
/area/overmap_encounter/planetoid/cave/explored)
"oo" = (
/obj/machinery/door/airlock/maintenance_hatch{
	dir = 4
	},
/turf/open/floor/plating,
/area/ruin/powered)
"os" = (
/obj/effect/decal/cleanable/blood/tracks,
/obj/effect/decal/cleanable/blood/footprints{
	dir = 1
	},
/turf/open/floor/plating/asteroid/snow/icemoon,
/area/overmap_encounter/planetoid/cave/explored)
"oB" = (
/obj/structure/table/wood,
/obj/structure/bedsheetbin/empty,
/obj/item/clothing/under/misc/pj/blue,
/obj/item/clothing/shoes/sneakers/white,
/turf/open/floor/wood,
/area/ruin/powered)
"oQ" = (
/obj/effect/decal/cleanable/blood/splatter,
/obj/effect/decal/cleanable/blood/footprints{
	dir = 8
	},
/turf/open/floor/plating/asteroid/snow/icemoon,
/area/overmap_encounter/planetoid/cave/explored)
"pH" = (
/obj/structure/sign/poster/official/work_for_a_future,
/turf/closed/wall/mineral/wood,
/area/ruin/powered)
"pP" = (
/obj/structure/chair/sofa/left{
	dir = 1
	},
/obj/effect/decal/cleanable/dirt,
/turf/open/floor/wood,
/area/ruin/powered)
"qV" = (
/obj/structure/fence/cut/medium{
	dir = 4
	},
/turf/open/floor/plating/asteroid/snow/icemoon,
/area/overmap_encounter/planetoid/cave/explored)
"rf" = (
/obj/structure/fence,
/turf/open/floor/plating/asteroid/snow/icemoon,
/area/overmap_encounter/planetoid/cave/explored)
"sG" = (
/obj/effect/decal/cleanable/vomit,
/obj/structure/toilet{
	dir = 1
	},
/turf/open/floor/plating,
/area/ruin/powered)
"sY" = (
/obj/structure/sink/kitchen{
	dir = 4;
	pixel_x = -12
	},
/obj/effect/decal/cleanable/dirt,
/obj/effect/turf_decal/corner/opaque/black{
	dir = 1
	},
/obj/effect/turf_decal/corner/opaque/black{
	dir = 2
	},
/turf/open/floor/plasteel,
/area/ruin/powered)
"tt" = (
/obj/effect/decal/cleanable/dirt,
/turf/open/floor/plasteel/freezer,
/area/ruin/powered)
"tX" = (
/obj/structure/table/wood,
/obj/structure/bedsheetbin,
/turf/open/floor/wood,
/area/ruin/powered)
"ut" = (
/obj/item/flashlight/lantern{
	on = 1
	},
/obj/effect/decal/cleanable/dirt,
/turf/open/floor/wood,
/area/ruin/powered)
"uu" = (
/obj/structure/bed,
/obj/item/bedsheet/dorms,
/turf/open/floor/wood,
/area/ruin/powered)
"uP" = (
/obj/structure/flora/ausbushes/fullgrass,
/obj/structure/flora/grass/both,
/turf/open/floor/plating/asteroid/snow/icemoon,
/area/overmap_encounter/planetoid/cave/explored)
"vh" = (
/turf/closed/mineral/ice,
/area/overmap_encounter/planetoid/cave/explored)
"wQ" = (
/turf/closed/wall,
/area/ruin/powered)
"xs" = (
/turf/open/floor/plating/ice/icemoon,
/area/overmap_encounter/planetoid/cave/explored)
"xD" = (
/obj/structure/bed,
/obj/effect/decal/cleanable/blood/bubblegum,
/obj/item/bedsheet/dorms,
/turf/open/floor/wood,
/area/ruin/powered)
"xN" = (
/obj/structure/bed/dogbed{
	pixel_y = 14
	},
/obj/effect/decal/cleanable/dirt,
/turf/open/floor/carpet,
/area/ruin/powered)
"yb" = (
/obj/structure/chair/sofa/right{
	dir = 1
	},
/turf/open/floor/wood,
/area/ruin/powered)
"yC" = (
/obj/structure/fence{
	dir = 8
	},
/turf/open/floor/plating/asteroid/snow/icemoon,
/area/overmap_encounter/planetoid/cave/explored)
"yD" = (
/turf/open/floor/plating/asteroid/snow/ice/icemoon,
/area/overmap_encounter/planetoid/cave/explored)
"yU" = (
/obj/structure/flora/rock/pile/icy,
/turf/open/floor/plating/asteroid/snow/icemoon,
/area/overmap_encounter/planetoid/cave/explored)
"zR" = (
/obj/machinery/door/airlock/wood,
/obj/effect/decal/cleanable/dirt,
/turf/open/floor/wood,
/area/ruin/powered)
"Ad" = (
/obj/structure/sign/poster/ripped,
/turf/closed/wall/rust,
/area/overmap_encounter/planetoid/cave/explored)
"AM" = (
/obj/effect/decal/cleanable/blood/gibs/down,
/obj/item/pickaxe,
/turf/open/floor/engine/cult,
/area/ruin/powered)
"AN" = (
/obj/structure/closet/cabinet,
/obj/item/restraints/legcuffs/beartrap,
/obj/item/restraints/legcuffs/beartrap,
/obj/item/reagent_containers/glass/bottle/venom,
/obj/item/reagent_containers/glass/bottle/curare,
/obj/item/kitchen/knife/combat/survival,
/obj/effect/decal/cleanable/dirt,
/obj/item/reagent_containers/food/snacks/meat/slab/human,
/obj/item/reagent_containers/food/snacks/meat/slab/human,
/obj/item/reagent_containers/food/snacks/meat/slab/human,
/turf/open/floor/wood,
/area/ruin/powered)
"BX" = (
/obj/item/reagent_containers/food/drinks/beer,
/turf/open/floor/plating/ice/icemoon,
/area/overmap_encounter/planetoid/cave/explored)
"Cd" = (
/obj/structure/chair/comfy/brown{
	dir = 8
	},
/turf/open/floor/carpet,
/area/ruin/powered)
"Cl" = (
/obj/structure/sacrificealtar,
/obj/effect/decal/cleanable/blood/old,
/obj/item/kitchen/knife/bloodletter,
/turf/open/floor/engine/cult,
/area/ruin/powered)
"CJ" = (
/obj/effect/decal/cleanable/blood/gibs/up,
/obj/effect/mob_spawn/human/corpse/assistant,
/mob/living/simple_animal/hostile/skeleton/eskimo{
	name = "Village Hunter"
	},
/turf/open/floor/plating/asteroid/snow/icemoon,
/area/overmap_encounter/planetoid/cave/explored)
"DI" = (
/obj/structure/closet/emcloset,
/obj/item/tank/internals/emergency_oxygen,
/obj/item/tank/internals/emergency_oxygen,
/obj/item/clothing/mask/breath/medical,
/obj/item/clothing/mask/breath/medical,
/obj/item/flashlight/lantern,
/turf/open/floor/plasteel/freezer,
/area/ruin/powered)
"Ed" = (
/obj/machinery/door/airlock/wood,
/obj/effect/mapping_helpers/airlock/locked,
/obj/structure/barricade/wooden/crude,
/turf/open/floor/wood,
/area/ruin/powered)
"Ee" = (
/obj/structure/flora/stump,
/turf/open/floor/plating/asteroid/snow/icemoon,
/area/overmap_encounter/planetoid/cave/explored)
"EF" = (
/obj/effect/decal/cleanable/blood/gibs/torso,
/obj/effect/decal/remains/human,
/mob/living/simple_animal/hostile/construct/juggernaut/hostile{
	health = 450;
	maxHealth = 450;
	name = "Left Hand of the Elder"
	},
/turf/open/floor/engine/cult,
/area/ruin/powered)
"Gr" = (
/obj/structure/closet/crate/trashcart,
/obj/effect/decal/cleanable/dirt,
/obj/item/trash/chips,
/obj/item/trash/semki{
	pixel_x = 8;
	pixel_y = -4
	},
/obj/item/clothing/neck/petcollar,
/turf/open/floor/plasteel/freezer,
/area/ruin/powered)
"Gy" = (
/obj/effect/decal/cleanable/dirt,
/obj/machinery/door/airlock/wood,
/turf/open/floor/plating,
/area/ruin/powered)
"GF" = (
/obj/structure/showcase/machinery/tv,
/obj/effect/decal/cleanable/dirt,
/obj/machinery/light/broken/directional/north,
/turf/open/floor/holofloor/wood,
/area/ruin/powered)
"GK" = (
/obj/item/clothing/head/bearpelt,
/obj/structure/table/wood,
/obj/item/reagent_containers/food/snacks/burger/fish,
/obj/item/reagent_containers/food/drinks/beer{
	pixel_x = -4
	},
/obj/item/reagent_containers/food/drinks/beer{
	pixel_x = 10;
	pixel_y = 6
	},
/turf/open/floor/wood,
/area/ruin/powered)
"GP" = (
/obj/effect/decal/cleanable/blood/footprints{
	dir = 1
	},
/obj/item/restraints/legcuffs/beartrap{
	armed = 1
	},
/obj/structure/flora/grass/both,
/turf/open/floor/plating/asteroid/snow/icemoon,
/area/overmap_encounter/planetoid/cave/explored)
"Ha" = (
/obj/structure/mirror{
	broken = 1
	},
/turf/closed/wall/mineral/wood,
/area/ruin/powered)
"Hf" = (
/obj/effect/decal/cleanable/blood/drip,
/turf/open/floor/wood,
/area/ruin/powered)
"Hg" = (
/turf/closed/mineral/snowmountain/cavern/icemoon,
/area/overmap_encounter/planetoid/cave/explored)
"Hx" = (
/obj/structure/closet/cabinet,
/obj/item/clothing/under/rank/cargo/miner,
/obj/item/clothing/suit/hooded/wintercoat/miner,
/obj/item/clothing/shoes/winterboots,
/obj/item/card/id/mining,
/obj/effect/decal/cleanable/dirt,
/turf/open/floor/wood,
/area/ruin/powered)
"HG" = (
/obj/structure/flora/ausbushes/fullgrass,
/obj/structure/flora/grass/both,
/obj/structure/fence{
	dir = 8
	},
/turf/open/floor/plating/asteroid/snow/icemoon,
/area/overmap_encounter/planetoid/cave/explored)
"Ir" = (
/obj/structure/chair/sofa/left,
/turf/closed/mineral/random/snow,
/area/overmap_encounter/planetoid/cave/explored)
"IA" = (
/obj/structure/fireplace{
	fuel_added = 1000;
	lit = 1
	},
/obj/effect/decal/cleanable/dirt,
/turf/open/floor/carpet,
/area/ruin/powered)
"Jy" = (
/obj/structure/flora/grass/both,
/obj/effect/decal/remains/human,
/turf/open/floor/plating/asteroid/snow/icemoon,
/area/overmap_encounter/planetoid/cave/explored)
"Kz" = (
/obj/structure/flora/ausbushes/fullgrass,
/turf/open/floor/plating/asteroid/snow/icemoon,
/area/overmap_encounter/planetoid/cave/explored)
"Mo" = (
/obj/machinery/light/small/directional/east,
/turf/open/floor/plating/asteroid/snow/icemoon,
/area/overmap_encounter/planetoid/cave/explored)
"Nb" = (
/obj/effect/decal/cleanable/blood/drip,
/turf/open/floor/plating/asteroid/snow/icemoon,
/area/overmap_encounter/planetoid/cave/explored)
"Nq" = (
/obj/effect/decal/cleanable/dirt,
/obj/structure/rack,
/obj/item/storage/bag/ore,
/obj/item/storage/toolbox/mechanical,
/turf/open/floor/plasteel/freezer,
/area/ruin/powered)
"NH" = (
/obj/effect/decal/cleanable/blood/tracks{
	dir = 4
	},
/obj/effect/decal/cleanable/blood/footprints{
	dir = 8
	},
/turf/open/floor/plating/asteroid/snow/icemoon,
/area/overmap_encounter/planetoid/cave/explored)
"Os" = (
/obj/structure/chair/comfy/brown{
	dir = 4
	},
/turf/open/floor/carpet,
/area/ruin/powered)
"Pp" = (
/obj/machinery/vending/snack/random,
/turf/open/floor/holofloor/wood,
/area/ruin/powered)
"PQ" = (
/obj/effect/decal/cleanable/blood/splatter,
/mob/living/simple_animal/hostile/illusion{
	deathmessage = "disperses into the air in a cloud of red mist, you feel slightly more at ease.";
	desc = "You can't quite make out what you're seeing.";
	faction = list("cult");
	health = 500;
	maxHealth = 500;
	melee_damage_lower = 10;
	melee_damage_upper = 30;
	name = "Village Elder"
	},
/turf/open/floor/engine/cult,
/area/ruin/powered)
"QE" = (
/obj/structure/flora/rock/icy,
/turf/open/floor/plating/asteroid/snow/icemoon,
/area/overmap_encounter/planetoid/cave/explored)
"QR" = (
/turf/closed/wall/rust,
/area/ruin/powered)
"QX" = (
/obj/effect/decal/cleanable/blood/splatter,
/turf/open/floor/plating/snowed/smoothed/icemoon,
/area/overmap_encounter/planetoid/cave/explored)
"Rg" = (
/obj/structure/fence/door/opened{
	dir = 8
	},
/turf/open/floor/plating/snowed/smoothed/icemoon,
/area/overmap_encounter/planetoid/cave/explored)
"Si" = (
/obj/structure/mirror,
/turf/closed/wall/mineral/wood,
/area/ruin/powered)
"Sn" = (
/obj/structure/closet/secure_closet/freezer,
/obj/item/reagent_containers/food/snacks/fishmeat/carp,
/obj/item/reagent_containers/food/snacks/fishmeat/carp,
/obj/item/reagent_containers/food/snacks/fishmeat/carp,
/obj/item/reagent_containers/food/condiment/pack/ketchup,
/obj/item/reagent_containers/food/condiment/pack/ketchup,
/obj/item/reagent_containers/food/condiment/pack/ketchup,
/obj/effect/turf_decal/corner/opaque/black{
	dir = 1
	},
/obj/effect/turf_decal/corner/opaque/black{
	dir = 2
	},
/turf/open/floor/plasteel,
/area/ruin/powered)
"SN" = (
/turf/open/floor/plasteel/freezer,
/area/ruin/powered)
"SZ" = (
/obj/machinery/door/airlock/wood,
/turf/open/floor/wood,
/area/ruin/powered)
"Ug" = (
/obj/structure/sign/poster/official/nanotrasen_logo,
/turf/closed/wall,
/area/overmap_encounter/planetoid/cave/explored)
"Um" = (
/obj/structure/flora/ausbushes/sparsegrass,
/turf/open/floor/plating/asteroid/snow/icemoon,
/area/overmap_encounter/planetoid/cave/explored)
"UI" = (
/obj/machinery/washing_machine,
/obj/effect/decal/cleanable/blood,
/obj/item/reagent_containers/food/snacks/meat/slab/corgi,
/turf/open/floor/wood,
/area/ruin/powered)
"Vn" = (
/turf/closed/wall/mineral/wood,
/area/ruin/powered)
"Wn" = (
/obj/structure/flora/tree/pine,
/turf/open/floor/plating/asteroid/snow/icemoon,
/area/overmap_encounter/planetoid/cave/explored)
"WH" = (
/obj/effect/decal/cleanable/dirt,
/obj/structure/bed,
/obj/item/bedsheet/cult,
/turf/open/floor/wood,
/area/ruin/powered)
"ZG" = (
/obj/effect/decal/cleanable/dirt,
/obj/structure/closet/cabinet,
/obj/item/clothing/suit/hooded/wintercoat,
/obj/item/clothing/shoes/winterboots,
/obj/item/clothing/under/suit/tan,
/turf/open/floor/wood,
/area/ruin/powered)

(1,1,1) = {"
ne
ne
ne
ne
ne
ne
ne
ne
ne
ne
ne
ne
ne
ne
ne
ne
ne
ne
ne
ne
ne
ne
ne
ne
ne
ne
ne
ne
"}
(2,1,1) = {"
ne
ne
ne
ne
yD
me
me
im
me
me
me
Mo
me
me
me
kn
me
me
me
me
me
me
me
ne
ne
ne
ne
ne
"}
(3,1,1) = {"
ne
ne
ne
xs
yD
me
me
Ad
yU
vh
me
Ug
me
me
me
me
me
me
yU
me
me
me
me
me
Ee
ne
ne
ne
"}
(4,1,1) = {"
ne
ne
ne
yD
me
me
ne
fm
vh
bz
vh
fm
ne
ne
ne
ne
ne
ne
ne
ne
Kz
yD
yD
me
me
yD
ne
ne
"}
(5,1,1) = {"
ne
ne
me
me
me
kn
ne
ne
vh
QX
yU
ne
ne
Vn
Vn
Vn
ne
ne
ne
ne
ne
ne
ne
yD
me
me
me
ne
"}
(6,1,1) = {"
ne
yU
me
me
Ee
ne
ne
ne
yU
aA
aA
aA
ne
Vn
UI
Vn
Vn
wQ
wQ
QR
QR
wQ
ne
ne
me
kn
me
ne
"}
(7,1,1) = {"
ne
me
QE
me
ne
ne
Vn
Vn
Vn
Vn
me
aA
Wn
pH
jk
tX
Vn
QR
DI
SN
lD
wQ
ne
ne
QE
me
me
ne
"}
(8,1,1) = {"
ne
me
me
me
ne
ne
Vn
cj
sY
Vn
me
aA
Vn
Vn
jk
oB
Vn
wQ
DI
tt
Gr
QR
Jy
ne
ne
me
me
ne
"}
(9,1,1) = {"
ne
me
me
ne
ne
CJ
Vn
Sn
ut
Vn
rf
Rg
Vn
GF
aM
yb
Vn
wQ
Nq
SN
QR
QR
me
ne
ne
me
me
ne
"}
(10,1,1) = {"
ne
me
nE
ne
ne
NH
Ha
li
Hf
SZ
aA
aA
Vn
Pp
aM
pP
Vn
wQ
QR
oo
wQ
me
Kz
ne
ne
me
me
ne
"}
(11,1,1) = {"
ne
me
yD
ne
ne
NH
Vn
Hx
xD
Vn
Nb
aA
Vn
Vn
cL
Vn
Vn
me
me
aA
yC
Wn
me
ne
ne
me
me
ne
"}
(12,1,1) = {"
ne
me
yD
ne
ne
NH
Vn
Vn
Vn
Vn
me
aA
me
Wn
aA
Kz
kI
aA
aA
aA
qV
me
me
ne
ne
ne
me
ne
"}
(13,1,1) = {"
ne
me
yD
ne
ne
oQ
os
GP
aH
me
Nb
aA
aA
aA
aA
me
me
aA
me
Vn
Vn
Vn
Vn
ne
ne
ne
yU
ne
"}
(14,1,1) = {"
ne
me
ne
ne
ne
Hg
Wn
Um
HG
me
me
me
me
me
aA
me
me
aA
me
Vn
uu
AN
Vn
ne
ne
ne
me
ne
"}
(15,1,1) = {"
ne
me
ne
Vn
Vn
Vn
Vn
Vn
Vn
Vn
Vn
me
aA
aA
aA
aA
aA
aA
aA
zR
cB
GK
Vn
ne
ne
Ee
me
ne
"}
(16,1,1) = {"
ne
me
ne
Vn
EF
hD
Si
aP
WH
ZG
Vn
me
aA
Kz
me
me
me
me
me
Vn
Vn
Vn
Vn
ne
ne
me
me
ne
"}
(17,1,1) = {"
ne
me
ne
Vn
Cl
PQ
Ed
jk
aM
aM
Vn
me
aA
me
me
me
Wn
me
me
me
Gy
sG
Vn
ne
ne
me
me
ne
"}
(18,1,1) = {"
ne
me
ne
Vn
mi
AM
Vn
ay
Os
jk
dh
aA
aA
me
me
me
me
uP
me
me
Vn
Vn
Vn
ne
ne
me
me
ne
"}
(19,1,1) = {"
ne
me
ne
Vn
Vn
Vn
Vn
IA
gG
aM
Vn
me
me
me
yD
in
me
me
hm
me
me
me
Wn
ne
ne
me
in
ne
"}
(20,1,1) = {"
ne
me
ne
ne
ne
Ir
Vn
xN
Cd
jk
Vn
uP
me
yD
xs
yD
yD
me
me
me
me
me
me
ne
ne
me
me
ne
"}
(21,1,1) = {"
ne
me
me
Um
ne
ne
Vn
Vn
Vn
Vn
Vn
me
in
yD
xs
xs
xs
yD
Um
me
me
kI
ne
ne
ne
me
me
ne
"}
(22,1,1) = {"
ne
Ee
me
me
ne
ne
ne
ne
Wn
me
me
me
yD
xs
BX
co
xs
xs
yD
yD
me
ne
ne
ne
Ee
me
me
ne
"}
(23,1,1) = {"
ne
ne
yU
me
me
ne
ne
ne
ne
kI
Kz
yD
yD
xs
xs
xs
xs
xs
xs
ne
ne
ne
ne
me
me
me
me
ne
"}
(24,1,1) = {"
ne
ne
ne
yD
me
me
me
ne
ne
ne
ne
ne
ne
xs
xs
xs
xs
xs
ne
ne
ne
ne
yU
QE
me
me
me
ne
"}
(25,1,1) = {"
ne
ne
ne
xs
yD
yD
me
ne
ne
ne
ne
ne
ne
ne
ne
ne
ne
ne
ne
ne
ne
me
me
me
me
me
me
ne
"}
(26,1,1) = {"
ne
ne
ne
xs
yD
QE
me
yU
ne
ne
ne
ne
ne
ne
ne
ne
ne
ne
ne
yD
me
me
me
yD
ne
me
me
ne
"}
(27,1,1) = {"
ne
ne
ne
ne
ne
ne
me
me
me
me
me
me
me
yU
QE
me
me
me
me
me
Ee
Kz
yD
ne
ne
yU
me
ne
"}
(28,1,1) = {"
ne
ne
ne
ne
ne
ne
ne
ne
ne
ne
ne
ne
ne
ne
ne
ne
ne
ne
ne
ne
ne
ne
ne
ne
ne
ne
ne
ne
"}
