//MAP CONVERTED BY dmm2tgm.py THIS HEADER COMMENT PREVENTS RECONVERSION, DO NOT REMOVE
"aa" = (
/turf/template_noop,
/area/template_noop)
"ab" = (
/turf/closed/wall/mineral/titanium/overspace,
/area/ruin/space/has_grav/powered/mechtransport)
"ac" = (
/obj/effect/spawner/structure/window/reinforced,
/turf/open/floor/plating,
/area/ruin/space/has_grav/powered/mechtransport)
"ad" = (
/turf/closed/wall/mineral/titanium,
/area/ruin/space/has_grav/powered/mechtransport)
"ae" = (
/obj/machinery/power/smes/shuttle/micro/precharged,
/obj/structure/cable{
	icon_state = "0-2"
	},
/turf/closed/wall/mineral/titanium,
/area/ruin/space/has_grav/powered/mechtransport)
"af" = (
/obj/structure/closet/crate/secure/loot,
/obj/effect/decal/cleanable/cobweb,
/turf/open/floor/mineral/titanium/blue,
/area/ruin/space/has_grav/powered/mechtransport)
"ag" = (
/obj/structure/closet/crate/secure/loot,
/turf/open/floor/mineral/titanium/blue,
/area/ruin/space/has_grav/powered/mechtransport)
"ah" = (
/obj/structure/table,
/obj/machinery/button/door{
	id = "mechaship1";
	name = "Mecha Cargo Ship Doors"
	},
/turf/open/floor/mineral/titanium/blue,
/area/ruin/space/has_grav/powered/mechtransport)
"ai" = (
/obj/structure/table,
/obj/effect/decal/cleanable/dirt,
/turf/open/floor/mineral/titanium/blue,
/area/ruin/space/has_grav/powered/mechtransport)
"aj" = (
/obj/machinery/computer/helm{
	dir = 8
	},
/turf/open/floor/mineral/titanium/blue,
/area/ruin/space/has_grav/powered/mechtransport)
"ak" = (
/obj/effect/decal/cleanable/vomit/old,
/turf/open/floor/mineral/titanium/blue,
/area/ruin/space/has_grav/powered/mechtransport)
"al" = (
/obj/effect/decal/remains/human,
/turf/open/floor/mineral/titanium/blue,
/area/ruin/space/has_grav/powered/mechtransport)
"am" = (
/obj/effect/decal/cleanable/dirt,
/turf/open/floor/mineral/titanium/blue,
/area/ruin/space/has_grav/powered/mechtransport)
"an" = (
/obj/structure/chair/office{
	dir = 1
	},
/turf/open/floor/mineral/titanium/blue,
/area/ruin/space/has_grav/powered/mechtransport)
"ao" = (
/obj/structure/lattice,
/turf/open/space,
/area/ruin/space/has_grav/powered/mechtransport)
"ap" = (
/obj/machinery/door/airlock/hatch{
	name = "Cockpit";
	req_access_txt = "101"
	},
/turf/open/floor/mineral/titanium,
/area/ruin/space/has_grav/powered/mechtransport)
"aq" = (
/obj/item/stack/sheet/metal,
/turf/open/space,
/area/ruin/space/has_grav/powered/mechtransport)
"ar" = (
/obj/effect/decal/cleanable/dirt,
/obj/effect/decal/cleanable/cobweb,
/turf/open/floor/mineral/titanium/airless,
/area/ruin/space/has_grav/powered/mechtransport)
"as" = (
/turf/open/floor/mineral/titanium/airless,
/area/ruin/space/has_grav/powered/mechtransport)
"at" = (
/obj/effect/decal/cleanable/dirt,
/turf/open/floor/mineral/titanium/airless,
/area/ruin/space/has_grav/powered/mechtransport)
"au" = (
/obj/effect/decal/cleanable/cobweb/cobweb2,
/turf/open/floor/mineral/titanium/airless,
/area/ruin/space/has_grav/powered/mechtransport)
"av" = (
/obj/structure/mecha_wreckage/phazon,
/turf/open/floor/mineral/titanium/yellow/airless,
/area/ruin/space/has_grav/powered/mechtransport)
"aw" = (
/turf/open/floor/mineral/titanium/yellow/airless,
/area/ruin/space/has_grav/powered/mechtransport)
"ax" = (
/obj/structure/mecha_wreckage/ripley/firefighter,
/turf/open/floor/mineral/titanium/yellow/airless,
/area/ruin/space/has_grav/powered/mechtransport)
"ay" = (
/obj/effect/decal/cleanable/dirt,
/turf/open/floor/mineral/titanium/yellow/airless,
/area/ruin/space/has_grav/powered/mechtransport)
"az" = (
/obj/structure/mecha_wreckage/ripley,
/turf/open/floor/mineral/titanium/yellow/airless,
/area/ruin/space/has_grav/powered/mechtransport)
"aA" = (
/obj/mecha/working/ripley{
	ruin_mecha = 1
	},
/turf/open/floor/mineral/titanium/yellow/airless,
/area/ruin/space/has_grav/powered/mechtransport)
"aB" = (
/obj/effect/decal/cleanable/oil,
/turf/open/floor/mineral/titanium/yellow/airless,
/area/ruin/space/has_grav/powered/mechtransport)
"aC" = (
/obj/effect/decal/cleanable/robot_debris/up,
/turf/open/floor/mineral/titanium/yellow/airless,
/area/ruin/space/has_grav/powered/mechtransport)
"aD" = (
/obj/machinery/door/poddoor{
	id = "mechaship1";
	name = "Cargo Bay Door"
	},
/turf/open/floor/mineral/titanium/yellow/airless,
/area/ruin/space/has_grav/powered/mechtransport)
"aE" = (
/obj/effect/decal/cleanable/robot_debris,
/turf/open/floor/mineral/titanium/yellow/airless,
/area/ruin/space/has_grav/powered/mechtransport)
"aF" = (
/obj/structure/mecha_wreckage/durand,
/turf/open/floor/mineral/titanium/yellow/airless,
/area/ruin/space/has_grav/powered/mechtransport)
"aG" = (
/obj/item/stack/tile/plasteel,
/turf/open/floor/plating/airless,
/area/ruin/space/has_grav/powered/mechtransport)
"aH" = (
/turf/open/floor/plating/airless,
/area/ruin/space/has_grav/powered/mechtransport)
"aI" = (
/obj/structure/lattice,
/turf/template_noop,
/area/ruin/space/has_grav/powered/mechtransport)
"aJ" = (
/obj/machinery/computer/mecha{
	dir = 8
	},
/turf/open/floor/mineral/titanium/blue,
/area/ruin/space/has_grav/powered/mechtransport)
"aK" = (
/obj/effect/decal/cleanable/robot_debris/gib,
/turf/open/floor/plating/airless,
/area/ruin/space/has_grav/powered/mechtransport)
"aL" = (
/obj/effect/decal/cleanable/robot_debris,
/obj/item/stack/tile/plasteel,
/turf/open/floor/mineral/titanium/yellow/airless,
/area/ruin/space/has_grav/powered/mechtransport)
"aM" = (
/turf/open/floor/plating/airless{
	icon_state = "platingdmg1"
	},
/area/ruin/space/has_grav/powered/mechtransport)
"aN" = (
/turf/open/floor/plating/airless{
	icon_state = "platingdmg2"
	},
/area/ruin/space/has_grav/powered/mechtransport)
"aO" = (
/obj/structure/mecha_wreckage/odysseus,
/turf/open/floor/mineral/titanium/yellow/airless,
/area/ruin/space/has_grav/powered/mechtransport)
"aP" = (
/obj/item/stack/sheet/metal,
/turf/template_noop,
/area/ruin/space/has_grav/powered/mechtransport)
"aQ" = (
/obj/structure/mecha_wreckage/gygax,
/turf/open/floor/mineral/titanium/airless,
/area/ruin/space/has_grav/powered/mechtransport)
"aR" = (
/turf/open/floor/plating/airless{
	icon_state = "platingdmg3"
	},
/area/ruin/space/has_grav/powered/mechtransport)
"aS" = (
/obj/item/stack/rods,
/turf/open/floor/plating/airless,
/area/ruin/space/has_grav/powered/mechtransport)
"aT" = (
/turf/template_noop,
/area/ruin/space/has_grav/powered/mechtransport)
"aU" = (
/turf/open/space,
/area/ruin/space/has_grav/powered/mechtransport)
"aV" = (
/obj/item/stack/rods,
/turf/template_noop,
/area/ruin/space/has_grav/powered/mechtransport)
"aW" = (
/obj/machinery/power/smes/shuttle/micro/precharged,
/obj/structure/cable{
	icon_state = "0-2"
	},
/turf/closed/wall/mineral/titanium/overspace,
/area/ruin/space/has_grav/powered/mechtransport)
"aX" = (
/obj/structure/shuttle/engine/propulsion,
/turf/template_noop,
/area/ruin/space/has_grav/powered/mechtransport)
"aY" = (
/obj/machinery/power/shuttle/engine/electric,
/obj/structure/cable,
/turf/open/floor/plating/airless,
/area/ruin/space/has_grav/powered/mechtransport)
"aZ" = (
/obj/item/stack/rods,
/turf/open/space,
/area/ruin/space/has_grav/powered/mechtransport)
"lV" = (
/obj/machinery/power/terminal,
/turf/closed/wall/mineral/titanium/overspace,
/area/ruin/space/has_grav/powered/mechtransport)
"wC" = (
/obj/machinery/power/terminal,
/turf/closed/wall/mineral/titanium,
/area/ruin/space/has_grav/powered/mechtransport)
"Xy" = (
/obj/machinery/door/poddoor{
	id = "mechaship1";
	name = "Cargo Bay Door";
	dir = 4
	},
/turf/open/floor/mineral/titanium/yellow/airless,
/area/ruin/space/has_grav/powered/mechtransport)

(1,1,1) = {"
aa
aa
aa
ab
ad
ad
ad
ad
aG
ao
aM
aq
aU
aU
aU
"}
(2,1,1) = {"
ab
ad
ad
ad
ar
av
aB
aE
aH
aS
aH
ao
aR
aZ
aU
"}
(3,1,1) = {"
ac
af
ak
ap
as
aw
aw
aF
aw
aH
aN
ao
ao
aU
aU
"}
(4,1,1) = {"
ac
ag
al
ad
at
aw
aC
aG
aF
aw
aG
aH
aq
aU
aU
"}
(5,1,1) = {"
ac
ah
am
ad
as
ax
aw
aw
ay
aK
aO
as
aS
ao
aU
"}
(6,1,1) = {"
ac
ai
an
ad
at
ay
az
aw
aH
aL
aO
aH
aH
aU
aU
"}
(7,1,1) = {"
ac
aj
aJ
ad
at
az
aw
aw
ay
aw
aw
aQ
wC
aW
aY
"}
(8,1,1) = {"
ab
ad
ad
ad
au
aA
ay
aw
aw
aB
ay
as
wC
ae
aY
"}
(9,1,1) = {"
aa
aa
aa
ab
ad
ad
Xy
Xy
Xy
Xy
Xy
ad
lV
aW
aY
"}
