//MAP CONVERTED BY dmm2tgm.py THIS HEADER COMMENT PREVENTS RECONVERSION, DO NOT REMOVE
"aq" = (
/obj/structure/table/reinforced,
/obj/item/storage/fancy/donut_box,
/obj/machinery/door/firedoor,
/obj/effect/turf_decal/corner/opaque/white{
	dir = 1
	},
/obj/effect/turf_decal/corner/opaque/white{
	dir = 2
	},
/obj/effect/turf_decal/corner/transparent/bar/diagonal{
	dir = 4
	},
/obj/machinery/door/poddoor/shutters,
/turf/open/floor/plasteel,
/area/ruin/unpowered)
"aH" = (
/obj/machinery/door/firedoor/border_only{
	dir = 4
	},
/obj/machinery/door/firedoor/border_only{
	dir = 8
	},
/obj/machinery/door/airlock/public/glass{
	dir = 4
	},
/turf/open/floor/plasteel/tech/grid,
/area/ruin/unpowered)
"br" = (
/obj/structure/sign/donk{
	pixel_y = 32
	},
/turf/open/floor/carpet/nanoweave/purple,
/area/ruin/unpowered)
"bv" = (
/turf/open/floor/plating{
	icon_state = "platingdmg1"
	},
/area/overmap_encounter/planetoid/wasteplanet/explored)
"cl" = (
/obj/machinery/atmospherics/components/unary/vent_pump/on/layer2{
	dir = 8
	},
/turf/open/floor/plating{
	icon_state = "panelscorched"
	},
/area/ruin/unpowered)
"dr" = (
/turf/closed/wall/mineral/titanium,
/area/ruin/unpowered)
"fE" = (
/obj/structure/curtain/bounty,
/obj/machinery/atmospherics/pipe/simple/scrubbers/hidden/layer4{
	dir = 1
	},
/turf/open/floor/eighties,
/area/ruin/unpowered)
"ga" = (
/turf/open/floor/wood,
/area/ruin/unpowered)
"gg" = (
/turf/open/floor/plating{
	icon_state = "platingdmg2"
	},
/area/ruin/unpowered)
"gh" = (
/obj/machinery/atmospherics/pipe/simple/supply/hidden/layer2{
	dir = 9
	},
/obj/machinery/atmospherics/components/unary/vent_pump/siphon/layer4{
	dir = 8
	},
/obj/item/oar,
/obj/machinery/advanced_airlock_controller{
	pixel_y = -24
	},
/obj/structure/closet/emcloset/wall{
	pixel_x = 28;
	dir = 8
	},
/turf/open/floor/plasteel/tech,
/area/ruin/unpowered)
"gO" = (
/obj/structure/table,
/turf/open/floor/carpet/nanoweave/purple,
/area/ruin/unpowered)
"gS" = (
/obj/structure/chair{
	dir = 4
	},
/obj/machinery/firealarm/directional/south,
/turf/open/floor/carpet/nanoweave/purple,
/area/ruin/unpowered)
"im" = (
/obj/structure/curtain/bounty,
/turf/open/floor/eighties,
/area/ruin/unpowered)
"iH" = (
/turf/template_noop,
/area/template_noop)
"ju" = (
/obj/structure/cable{
	icon_state = "1-2"
	},
/obj/machinery/atmospherics/pipe/simple/supply/hidden/layer2,
/obj/machinery/atmospherics/pipe/simple/scrubbers/hidden/layer4{
	dir = 1
	},
/turf/open/floor/carpet/nanoweave/purple,
/area/ruin/unpowered)
"jX" = (
/turf/open/floor/plating{
	icon_state = "platingdmg1"
	},
/area/ruin/unpowered)
"kb" = (
/turf/open/floor/plating{
	icon_state = "panelscorched"
	},
/area/overmap_encounter/planetoid/wasteplanet/explored)
"lN" = (
/obj/structure/table/reinforced,
/obj/item/reagent_containers/food/condiment/saltshaker{
	pixel_x = -6;
	pixel_y = 2
	},
/obj/item/reagent_containers/food/condiment/peppermill{
	pixel_y = 2
	},
/obj/machinery/door/firedoor,
/obj/effect/turf_decal/corner/opaque/white{
	dir = 1
	},
/obj/effect/turf_decal/corner/opaque/white{
	dir = 2
	},
/obj/effect/turf_decal/corner/transparent/bar/diagonal{
	dir = 4
	},
/obj/machinery/door/poddoor/shutters,
/turf/open/floor/plasteel,
/area/ruin/unpowered)
"me" = (
/obj/structure/table,
/obj/structure/frame/machine,
/obj/structure/table,
/obj/item/circuitboard/machine/chem_dispenser/drinks/beer,
/turf/open/floor/plating{
	icon_state = "platingdmg2"
	},
/area/ruin/unpowered)
"pa" = (
/turf/closed/wall/mineral/titanium/nodiagonal,
/area/ruin/unpowered)
"pc" = (
/obj/machinery/atmospherics/components/unary/vent_pump/on/layer2{
	dir = 4
	},
/obj/effect/turf_decal/corner/opaque/white{
	dir = 1
	},
/obj/effect/turf_decal/corner/opaque/white{
	dir = 2
	},
/obj/effect/turf_decal/corner/transparent/bar/diagonal{
	dir = 4
	},
/turf/open/floor/plasteel,
/area/ruin/unpowered)
"sI" = (
/mob/living/simple_animal/hostile/hivebot/rapid,
/turf/open/floor/plating{
	icon_state = "platingdmg1"
	},
/area/ruin/unpowered)
"sQ" = (
/turf/open/floor/plating{
	icon_state = "panelscorched"
	},
/area/ruin/unpowered)
"sV" = (
/obj/machinery/atmospherics/components/unary/vent_scrubber/on/layer4,
/turf/open/floor/plating,
/area/ruin/unpowered)
"tm" = (
/obj/structure/table,
/obj/machinery/reagentgrinder{
	pixel_x = -2;
	pixel_y = 2
	},
/obj/item/reagent_containers/glass/beaker/large{
	pixel_x = 6;
	pixel_y = 6
	},
/obj/machinery/firealarm/directional/west,
/obj/effect/turf_decal/corner/opaque/white{
	dir = 1
	},
/obj/effect/turf_decal/corner/opaque/white{
	dir = 2
	},
/obj/effect/turf_decal/corner/transparent/bar/diagonal{
	dir = 4
	},
/turf/open/floor/plasteel,
/area/ruin/unpowered)
"tI" = (
/obj/structure/cable{
	icon_state = "1-2"
	},
/obj/machinery/atmospherics/pipe/simple/supply/hidden/layer2,
/obj/machinery/atmospherics/pipe/simple/scrubbers/hidden/layer4{
	dir = 1
	},
/obj/structure/sign/solgov_seal{
	pixel_x = -27;
	pixel_y = 0
	},
/turf/open/floor/wood,
/area/ruin/unpowered)
"vc" = (
/obj/structure/cable{
	icon_state = "4-8"
	},
/obj/machinery/light/directional/south,
/obj/machinery/atmospherics/pipe/simple/supply/hidden/layer2{
	dir = 4
	},
/obj/machinery/atmospherics/pipe/simple/scrubbers/hidden/layer4{
	dir = 4
	},
/turf/open/floor/carpet/nanoweave/purple,
/area/ruin/unpowered)
"wG" = (
/obj/structure/girder,
/obj/structure/girder,
/turf/open/floor/plating{
	icon_state = "panelscorched"
	},
/area/ruin/unpowered)
"xh" = (
/obj/structure/girder,
/turf/open/floor/plating{
	icon_state = "platingdmg1"
	},
/area/ruin/unpowered)
"xi" = (
/obj/structure/girder,
/turf/open/floor/plating,
/area/ruin/unpowered)
"xD" = (
/obj/structure/table,
/obj/item/storage/bag/tray,
/obj/item/reagent_containers/food/drinks/shaker,
/obj/item/reagent_containers/glass/rag,
/obj/item/reagent_containers/food/condiment/enzyme,
/obj/item/kitchen/knife,
/obj/effect/turf_decal/corner/opaque/white{
	dir = 1
	},
/obj/effect/turf_decal/corner/opaque/white{
	dir = 2
	},
/obj/effect/turf_decal/corner/transparent/bar/diagonal{
	dir = 4
	},
/turf/open/floor/plasteel,
/area/ruin/unpowered)
"xU" = (
/obj/machinery/door/airlock/public/glass{
	name = "Crew Quarters"
	},
/obj/structure/cable{
	icon_state = "1-2"
	},
/obj/machinery/door/firedoor/border_only,
/obj/machinery/door/firedoor/border_only{
	dir = 1
	},
/obj/machinery/atmospherics/pipe/simple/supply/hidden/layer2,
/obj/machinery/atmospherics/pipe/simple/scrubbers/hidden/layer4{
	dir = 1
	},
/turf/open/floor/wood,
/area/ruin/unpowered)
"yE" = (
/obj/structure/sign/warning/docking,
/turf/closed/wall/mineral/titanium,
/area/ruin/unpowered)
"Al" = (
/obj/structure/window/reinforced/tinted/frosted{
	dir = 1
	},
/turf/open/floor/plating{
	icon_state = "panelscorched"
	},
/area/ruin/unpowered)
"CG" = (
/obj/structure/girder,
/obj/merge_conflict_marker{
	name = "---Merge Conflict Marker---",desc = "A best-effort merge was performed. You must resolve this conflict yourself (manually) and remove this object once complete."
	},
/obj/structure/extinguisher_cabinet/directional/north,
/obj/structure/girder,
/obj/merge_conflict_marker{
	name = "---Merge Conflict Marker---",
	desc = "A best-effort merge was performed. You must resolve this conflict yourself (manually) and remove this object once complete."
	},
/obj/structure/girder,
/turf/open/floor/plating{
	icon_state = "panelscorched"
	},
/area/ruin/unpowered)
"DF" = (
/obj/machinery/door/window/westleft,
/obj/structure/sink{
	dir = 8;
	pixel_x = 12
	},
/obj/structure/mirror{
	pixel_x = 24
	},
/turf/open/floor/plasteel/white,
/area/ruin/unpowered)
"Eg" = (
/mob/living/simple_animal/hostile/hivebot/rapid,
/turf/open/floor/plating{
	icon_state = "platingdmg2"
	},
/area/overmap_encounter/planetoid/wasteplanet/explored)
"Fq" = (
/obj/item/electronics/apc,
/turf/open/floor/plating{
	icon_state = "platingdmg1"
	},
/area/ruin/unpowered)
"Hv" = (
/obj/structure/table,
/obj/machinery/chem_dispenser/drinks,
/obj/effect/turf_decal/corner/opaque/white{
	dir = 1
	},
/obj/effect/turf_decal/corner/opaque/white{
	dir = 2
	},
/obj/effect/turf_decal/corner/transparent/bar/diagonal{
	dir = 4
	},
/turf/open/floor/plasteel,
/area/ruin/unpowered)
"HV" = (
/obj/structure/curtain,
/obj/machinery/shower{
	pixel_y = 8
	},
/obj/structure/window/reinforced/tinted/frosted{
	dir = 8
	},
/obj/item/soap,
/mob/living/simple_animal/hostile/hivebot/rapid,
/turf/open/floor/plasteel/white,
/area/ruin/unpowered)
"Ka" = (
/obj/machinery/power/terminal{
	dir = 8
	},
/obj/structure/cable,
/obj/machinery/atmospherics/pipe/simple/supply/hidden/layer2{
	dir = 5
	},
/obj/machinery/atmospherics/pipe/simple/scrubbers/hidden/layer4{
	dir = 1
	},
/turf/open/floor/wood,
/area/ruin/unpowered)
"KR" = (
/turf/open/floor/plating,
/area/ruin/unpowered)
"Ly" = (
/obj/machinery/door/airlock/public/glass{
	dir = 4
	},
/obj/structure/cable{
	icon_state = "4-8"
	},
/obj/machinery/door/firedoor/border_only{
	dir = 8
	},
/obj/machinery/door/firedoor/border_only{
	dir = 4
	},
/obj/machinery/atmospherics/pipe/simple/supply/hidden/layer2{
	dir = 4
	},
/obj/machinery/atmospherics/pipe/simple/scrubbers/hidden/layer4{
	dir = 4
	},
/turf/open/floor/plasteel/tech/grid,
/area/ruin/unpowered)
"Lz" = (
/obj/item/ammo_casing/spent{
	dir = 1;
	pixel_x = 7;
	pixel_y = 4
	},
/obj/effect/decal/cleanable/blood/gibs,
/obj/item/gun/ballistic/automatic/pistol/commander{
	pixel_y = 7
	},
/obj/effect/mob_spawn/human/corpse/assistant,
/turf/open/floor/plating{
	icon_state = "panelscorched"
	},
/area/ruin/unpowered)
"Mi" = (
/obj/structure/grille,
/turf/open/floor/plating,
/area/ruin/unpowered)
"MI" = (
/turf/open/floor/plating/asteroid/wasteplanet,
/area/overmap_encounter/planetoid/wasteplanet/explored)
"Nb" = (
/obj/structure/girder,
/turf/open/floor/plating{
	icon_state = "panelscorched"
	},
/area/ruin/unpowered)
"QS" = (
/obj/structure/chair/comfy/teal,
/obj/machinery/airalarm/directional/north,
/turf/open/floor/wood,
/area/ruin/unpowered)
"Rt" = (
/obj/effect/spawner/structure/window/shuttle,
/obj/machinery/door/firedoor/window,
/obj/structure/grille,
/obj/machinery/door/poddoor/shutters/preopen{
	id = "sgwindowshut";
	name = "External Shutters"
	},
/turf/open/floor/plating,
/area/ruin/unpowered)
"RL" = (
/obj/structure/lattice,
/obj/structure/girder,
/turf/open/floor/plating{
	icon_state = "panelscorched"
	},
/area/ruin/unpowered)
"Sh" = (
/obj/machinery/light/small/directional/east,
/obj/machinery/door/window/westright,
/obj/structure/window/reinforced/spawner,
/obj/machinery/atmospherics/components/binary/pump/layer2,
/turf/open/floor/plating{
	icon_state = "platingdmg1"
	},
/area/ruin/unpowered)
"Te" = (
/obj/structure/table,
/obj/machinery/microwave,
/obj/effect/turf_decal/corner/opaque/white{
	dir = 1
	},
/obj/effect/turf_decal/corner/opaque/white{
	dir = 2
	},
/obj/effect/turf_decal/corner/transparent/bar/diagonal{
	dir = 4
	},
/turf/open/floor/plasteel,
/area/ruin/unpowered)
"TT" = (
/obj/structure/chair{
	dir = 8
	},
/obj/structure/extinguisher_cabinet/directional/south,
/turf/open/floor/carpet/nanoweave/purple,
/area/ruin/unpowered)
"Uu" = (
/obj/effect/decal/fakelattice,
/turf/open/floor/plating/asteroid/wasteplanet,
/area/overmap_encounter/planetoid/wasteplanet/explored)
"UA" = (
/obj/machinery/gibber,
/obj/effect/turf_decal/corner/opaque/white{
	dir = 1
	},
/obj/effect/turf_decal/corner/opaque/white{
	dir = 2
	},
/obj/effect/turf_decal/corner/transparent/bar/diagonal{
	dir = 4
	},
/turf/open/floor/plating{
	icon_state = "panelscorched"
	},
/area/ruin/unpowered)
"Vn" = (
/obj/structure/cable{
	icon_state = "4-8"
	},
/obj/structure/cable{
	icon_state = "2-8"
	},
/obj/machinery/atmospherics/pipe/manifold/scrubbers/hidden/layer4{
	dir = 1
	},
/obj/machinery/atmospherics/pipe/manifold/supply/hidden/layer2{
	dir = 1
	},
/turf/open/floor/carpet/nanoweave/purple,
/area/ruin/unpowered)
"Vy" = (
/obj/structure/table,
/obj/effect/spawner/lootdrop/donkpockets,
/obj/machinery/button/door{
	id = "sgkitchen";
	name = "Kitchen Shutters";
	pixel_y = -22
	},
/obj/machinery/camera/autoname{
	dir = 1;
	network = list("cricket")
	},
/obj/effect/turf_decal/corner/opaque/white{
	dir = 1
	},
/obj/effect/turf_decal/corner/opaque/white{
	dir = 2
	},
/obj/effect/turf_decal/corner/transparent/bar/diagonal{
	dir = 4
	},
/turf/open/floor/plasteel,
/area/ruin/unpowered)
"VG" = (
/obj/machinery/atmospherics/components/unary/tank/air{
	piping_layer = 2
	},
/obj/structure/window/reinforced/spawner/west,
/obj/machinery/camera/autoname{
	dir = 8;
	network = list("cricket")
	},
/turf/open/floor/plasteel/tech,
/area/ruin/unpowered)
"WP" = (
/mob/living/simple_animal/hostile/hivebot/rapid,
/turf/open/floor/plating,
/area/ruin/unpowered)

(1,1,1) = {"
MI
iH
MI
Uu
Uu
Uu
Eg
bv
kb
Uu
Uu
MI
iH
MI
iH
iH
"}
(2,1,1) = {"
yE
VG
Sh
gh
pa
aH
Ly
pa
pa
Nb
dr
dr
Uu
iH
iH
iH
"}
(3,1,1) = {"
Nb
Nb
dr
pa
pa
KR
Vn
ju
xU
tI
Ka
fE
KR
Uu
MI
iH
"}
(4,1,1) = {"
Nb
UA
tm
Te
xh
sQ
jX
gS
dr
QS
cl
im
gg
sQ
Uu
MI
"}
(5,1,1) = {"
Rt
xD
pc
WP
lN
sV
sQ
gO
dr
Fq
ga
Al
jX
KR
Uu
Uu
"}
(6,1,1) = {"
Rt
me
jX
Lz
aq
sQ
jX
TT
pa
HV
DF
pa
sQ
Uu
iH
MI
"}
(7,1,1) = {"
Mi
Hv
KR
Vy
dr
br
vc
CG
pa
Nb
pa
pa
Uu
MI
iH
iH
"}
(8,1,1) = {"
RL
pa
pa
xi
wG
gg
jX
jX
sQ
Nb
Uu
MI
MI
iH
iH
iH
"}
(9,1,1) = {"
MI
MI
Uu
Uu
sQ
KR
sI
sQ
Uu
Uu
MI
iH
iH
iH
iH
iH
"}
(10,1,1) = {"
iH
iH
MI
iH
MI
Uu
Uu
Uu
MI
iH
MI
iH
iH
iH
iH
iH
"}
(11,1,1) = {"
iH
iH
iH
iH
iH
MI
Uu
MI
iH
iH
iH
iH
iH
iH
iH
iH
"}
