//MAP CONVERTED BY dmm2tgm.py THIS HEADER COMMENT PREVENTS RECONVERSION, DO NOT REMOVE
"aa" = (
/turf/template_noop,
/area/template_noop)
"ab" = (
/turf/open/floor/plating/rust,
/area/ruin)
"ac" = (
/obj/structure/sign/warning/radiation,
/turf/closed/wall/r_wall,
/area/ruin)
"ad" = (
/obj/structure/radioactive/stack,
/turf/open/floor/plating/asteroid/wasteplanet,
/area/overmap_encounter/planetoid/wasteplanet/explored)
"ae" = (
/obj/structure/reagent_dispensers/fueltank,
/turf/open/floor/plating/rust,
/area/ruin)
"af" = (
/obj/effect/decal/remains/human,
/obj/effect/decal/cleanable/blood/old,
/obj/item/clothing/suit/radiation,
/obj/item/clothing/head/radiation{
	pixel_y = 8
	},
/turf/open/floor/plating/asteroid/wasteplanet,
/area/overmap_encounter/planetoid/wasteplanet/explored)
"ag" = (
/obj/structure/fence{
	dir = 8
	},
/turf/open/floor/plating/asteroid/wasteplanet,
/area/overmap_encounter/planetoid/wasteplanet/explored)
"ah" = (
/obj/structure/fence/door,
/turf/open/floor/plating/asteroid/wasteplanet,
/area/overmap_encounter/planetoid/wasteplanet/explored)
"ai" = (
/obj/effect/gibspawner,
/turf/open/floor/plating/rust,
/area/ruin)
"aj" = (
/obj/item/grenade/syndieminibomb,
/obj/item/ammo_box/magazine/aknt,
/turf/open/floor/plating/rust,
/area/ruin)
"ak" = (
/obj/structure/radioactive/stack,
/turf/open/floor/plating/asteroid/rockplanet/lit,
/area/ruin)
"al" = (
/obj/structure/table/reinforced,
/obj/item/ammo_box/magazine/aknt{
	pixel_x = -15;
	pixel_y = -9
	},
/turf/open/floor/plating/rust,
/area/ruin)
"am" = (
/obj/effect/radiation,
/turf/open/floor/plating/asteroid/rockplanet/lit,
/area/ruin)
"an" = (
/obj/item/ammo_box/magazine/aknt,
/turf/open/floor/plating/rust{
	initial_gas_mix = "plasma=70000;TEMP=293.15"
	},
/area/ruin)
"ao" = (
/obj/structure/fence/door,
/turf/open/floor/plating/asteroid/rockplanet/lit,
/area/ruin)
"ap" = (
/obj/item/stack/sheet/mineral/uranium/five,
/obj/effect/mine/shrapnel,
/turf/open/floor/plating/rust,
/area/ruin)
"aq" = (
/obj/structure/table/reinforced,
/obj/item/gun/ballistic/automatic/assualt/ak47/nt,
/turf/open/floor/plating/rust,
/area/ruin)
"ar" = (
/obj/item/stack/sheet/mineral/uranium/five,
/turf/open/floor/plating/rust,
/area/ruin)
"as" = (
/obj/structure/fence/corner{
	dir = 10
	},
/turf/open/floor/plating/asteroid/rockplanet/lit,
/area/ruin)
"at" = (
/obj/item/stack/sheet/mineral/uranium/five,
/obj/structure/radioactive/stack,
/turf/open/floor/plating/rust,
/area/ruin)
"au" = (
/obj/effect/radiation,
/turf/open/floor/plating/rust,
/area/ruin)
"av" = (
/obj/machinery/door/airlock/vault,
/obj/effect/mapping_helpers/airlock/locked,
/turf/open/floor/plating/rust,
/area/ruin/powered)
"aw" = (
/turf/open/floor/plating/asteroid/wasteplanet,
/area/overmap_encounter/planetoid/wasteplanet/explored)
"ax" = (
/obj/item/stack/sheet/mineral/uranium/five,
/obj/structure/radioactive,
/turf/open/floor/plating/rust,
/area/ruin)
"ay" = (
/obj/structure/table/reinforced,
/obj/item/gun/energy/e_gun/nuclear,
/turf/open/floor/plating/rust,
/area/ruin)
"az" = (
/obj/structure/sign/warning/radiation,
/turf/closed/wall/r_wall/rust,
/area/ruin)
"aA" = (
/obj/item/grenade/frag,
/obj/structure/reagent_dispensers/fueltank,
/turf/open/floor/plating/rust,
/area/ruin)
"aB" = (
/turf/closed/wall/r_wall/rust,
/area/ruin)
"aC" = (
/obj/item/ammo_box/magazine/aknt,
/obj/structure/reagent_dispensers/fueltank,
/turf/open/floor/plating/rust,
/area/ruin)
"aD" = (
/obj/structure/fence,
/turf/open/floor/plating/asteroid/rockplanet/lit,
/area/ruin)
"aE" = (
/obj/structure/marker_beacon,
/turf/open/floor/plating/asteroid/wasteplanet,
/area/overmap_encounter/planetoid/wasteplanet/explored)
"aF" = (
/turf/closed/wall/r_wall,
/area/ruin)
"aG" = (
/obj/item/stack/sheet/mineral/uranium/five,
/obj/effect/gibspawner,
/turf/open/floor/plating/rust,
/area/ruin)
"aH" = (
/obj/item/grenade/stingbang,
/turf/open/floor/plating/rust,
/area/ruin)
"aI" = (
/obj/item/flashlight/lantern,
/turf/open/floor/plating/rust,
/area/ruin)
"aJ" = (
/obj/structure/radioactive,
/turf/open/floor/plating/rust,
/area/ruin)
"aK" = (
/obj/effect/mine/shrapnel,
/turf/open/floor/plating/asteroid/rockplanet/lit,
/area/ruin)
"aL" = (
/obj/structure/sign/warning/radiation,
/turf/open/floor/plating/asteroid/rockplanet/lit,
/area/ruin)
"aM" = (
/turf/open/floor/plating/asteroid/rockplanet/lit,
/area/ruin)
"aN" = (
/obj/structure/fence/corner{
	dir = 10
	},
/turf/open/floor/plating/asteroid/wasteplanet,
/area/overmap_encounter/planetoid/wasteplanet/explored)
"aO" = (
/obj/structure/marker_beacon,
/turf/open/floor/plating/asteroid/rockplanet/lit,
/area/ruin)
"aP" = (
/obj/effect/gibspawner,
/obj/structure/radioactive/waste,
/turf/open/floor/plating/rust,
/area/ruin)
"aQ" = (
/obj/structure/fence/corner,
/turf/open/floor/plating/asteroid/rockplanet/lit,
/area/ruin)
"aR" = (
/obj/effect/decal/remains/human,
/obj/effect/decal/cleanable/blood/old,
/obj/item/clothing/suit/radiation,
/obj/item/clothing/head/radiation{
	pixel_y = 8
	},
/turf/open/floor/plating/asteroid/rockplanet/lit,
/area/ruin)
"aS" = (
/obj/structure/sign/warning/longtermwaste{
	pixel_y = 32
	},
/obj/structure/radioactive,
/turf/open/floor/plating/asteroid/rockplanet/lit,
/area/ruin)
"aT" = (
/obj/structure/fence,
/turf/open/floor/plating/asteroid/wasteplanet,
/area/overmap_encounter/planetoid/wasteplanet/explored)
"aU" = (
/obj/structure/radioactive,
/turf/open/floor/plating/asteroid/rockplanet/lit,
/area/ruin)
"aV" = (
/obj/structure/sign/warning/radiation,
/turf/open/floor/plating/asteroid/wasteplanet,
/area/overmap_encounter/planetoid/wasteplanet/explored)
"aW" = (
/obj/structure/fence{
	dir = 8
	},
/turf/open/floor/plating/asteroid/rockplanet/lit,
/area/ruin)
"aX" = (
/obj/structure/fence/corner,
/turf/open/floor/plating/asteroid/wasteplanet,
/area/overmap_encounter/planetoid/wasteplanet/explored)
"aY" = (
/obj/item/ammo_box/magazine/aknt,
/turf/open/floor/plating/rust,
/area/ruin)
"aZ" = (
/obj/effect/mine/shrapnel,
/turf/open/floor/plating/rust,
/area/ruin)
"fM" = (
/obj/effect/gibspawner,
/turf/open/floor/plating/asteroid/wasteplanet,
/area/ruin)
"jd" = (
/obj/item/ammo_box/magazine/aknt,
/turf/open/floor/plating/asteroid/wasteplanet,
/area/ruin)
"kk" = (
/obj/item/stack/sheet/mineral/uranium/five,
/obj/effect/gibspawner,
/turf/open/floor/plating/asteroid/wasteplanet,
/area/ruin)
"qN" = (
/obj/item/stack/sheet/mineral/uranium/five,
/obj/effect/mine/shrapnel,
/turf/open/floor/plating/asteroid/wasteplanet,
/area/ruin)
"vg" = (
/obj/effect/gibspawner,
/obj/structure/radioactive/waste,
/turf/open/floor/plating/asteroid/wasteplanet,
/area/ruin)
"wK" = (
/obj/item/grenade/frag,
/obj/structure/reagent_dispensers/fueltank,
/turf/open/floor/plating/asteroid/wasteplanet,
/area/ruin)
"yI" = (
/obj/structure/radioactive,
/turf/open/floor/plating/asteroid/wasteplanet,
/area/ruin)
"zP" = (
/obj/item/flashlight/lantern,
/turf/open/floor/plating/asteroid/wasteplanet,
/area/ruin)
"BO" = (
/obj/machinery/door/airlock/vault,
/obj/effect/mapping_helpers/airlock/locked,
/turf/open/floor/plating/asteroid/wasteplanet,
/area/ruin/powered)
"IN" = (
/obj/structure/table/reinforced,
/obj/item/ammo_box/magazine/aknt{
	pixel_x = -15;
	pixel_y = -9
	},
/turf/open/floor/plating/asteroid/wasteplanet,
/area/ruin)
"Lj" = (
/obj/structure/radioactive,
/turf/open/floor/plating/asteroid/wasteplanet,
/area/overmap_encounter/planetoid/wasteplanet/explored)
"Ll" = (
/obj/item/stack/sheet/mineral/uranium/five,
/obj/structure/radioactive,
/turf/open/floor/plating/asteroid/wasteplanet,
/area/ruin)
"Ly" = (
/obj/item/stack/sheet/mineral/uranium/five,
/turf/open/floor/plating/asteroid/wasteplanet,
/area/ruin)
"LW" = (
/obj/effect/mine/shrapnel,
/turf/open/floor/plating/asteroid/wasteplanet,
/area/ruin)
"MH" = (
/obj/effect/radiation,
/turf/open/floor/plating/asteroid/wasteplanet,
/area/ruin)
"NL" = (
/obj/structure/table/reinforced,
/obj/item/gun/energy/e_gun/nuclear,
/turf/open/floor/plating/asteroid/wasteplanet,
/area/ruin)
"Pi" = (
/obj/item/ammo_box/magazine/aknt,
/obj/structure/reagent_dispensers/fueltank,
/turf/open/floor/plating/asteroid/wasteplanet,
/area/ruin)
"RZ" = (
/turf/open/floor/plating/asteroid/wasteplanet,
/area/ruin)
"SF" = (
/obj/structure/reagent_dispensers/fueltank,
/turf/open/floor/plating/asteroid/wasteplanet,
/area/ruin)
"SW" = (
/obj/effect/mine/shrapnel,
/turf/open/floor/plating/asteroid/wasteplanet,
/area/overmap_encounter/planetoid/wasteplanet/explored)
"Tx" = (
/obj/item/stack/sheet/mineral/uranium/five,
/obj/structure/radioactive/stack,
/turf/open/floor/plating/asteroid/wasteplanet,
/area/ruin)
"Ue" = (
/obj/structure/sign/warning/longtermwaste{
	pixel_y = 32
	},
/obj/structure/radioactive,
/turf/open/floor/plating/asteroid/wasteplanet,
/area/overmap_encounter/planetoid/wasteplanet/explored)
"UZ" = (
/obj/item/grenade/stingbang,
/turf/open/floor/plating/asteroid/wasteplanet,
/area/ruin)
"Vq" = (
/obj/structure/table/reinforced,
/obj/item/gun/ballistic/automatic/assualt/ak47/nt,
/turf/open/floor/plating/asteroid/wasteplanet,
/area/ruin)
"WD" = (
/obj/item/grenade/syndieminibomb,
/obj/item/ammo_box/magazine/aknt,
/turf/open/floor/plating/asteroid/wasteplanet,
/area/ruin)
"ZI" = (
/obj/effect/radiation,
/turf/open/floor/plating/asteroid/wasteplanet,
/area/overmap_encounter/planetoid/wasteplanet/explored)

(1,1,1) = {"
ac
aB
aF
aB
aF
aF
aF
aF
az
aa
aa
aa
aa
aa
aa
aa
aa
"}
(2,1,1) = {"
aB
aF
aB
aF
aB
aF
aB
aF
aF
aT
aT
aT
aT
aT
aT
aN
aa
"}
(3,1,1) = {"
aB
aB
Ll
yI
SF
fM
Tx
aB
aF
aw
ad
aw
aw
Lj
aw
ag
aa
"}
(4,1,1) = {"
aB
aB
yI
kk
RZ
WD
RZ
aF
aB
Ue
aw
aw
aw
aw
aw
ag
aa
"}
(5,1,1) = {"
aF
aF
NL
jd
qN
SF
Ly
aB
aF
aw
aw
aw
SW
aw
aw
ag
aa
"}
(6,1,1) = {"
aF
aB
Vq
wK
MH
RZ
zP
aB
aE
aw
ZI
aw
aw
aw
ad
aV
aE
"}
(7,1,1) = {"
aB
aB
IN
jd
fM
Pi
LW
BO
aw
aw
Lj
aw
aw
aw
aw
ah
aw
"}
(8,1,1) = {"
aB
aF
Ly
qN
UZ
RZ
fM
aB
aE
aw
aw
aw
Lj
aw
aw
ag
aE
"}
(9,1,1) = {"
aF
aF
vg
RZ
SF
Ly
yI
aB
aF
aw
aw
aw
aw
aw
aw
ag
aa
"}
(10,1,1) = {"
aF
aF
aF
aF
aB
aB
aF
aF
aF
aT
aT
aT
aT
aT
aT
aX
aa
"}
(11,1,1) = {"
az
aF
aF
aB
aB
aB
aB
aB
ac
aa
aa
aa
aa
aa
af
aa
aa
"}
