//MAP CONVERTED BY dmm2tgm.py THIS HEADER COMMENT PREVENTS RECONVERSION, DO NOT REMOVE
"aJ" = (
/obj/effect/turf_decal/road/line/edge/opaque/yellow,
/obj/effect/turf_decal/road/stripes,
/turf/open/floor/concrete/pavement,
/area/overmap_encounter/planetoid/wasteplanet/explored)
"aP" = (
/obj/effect/turf_decal/road/edge{
	dir = 1
	},
/turf/open/floor/concrete/pavement,
/area/overmap_encounter/planetoid/wasteplanet/explored)
"bB" = (
/obj/effect/turf_decal/road/line/opaque/yellow{
	dir = 4
	},
/obj/structure/barricade/sandbags,
/turf/open/floor/concrete/pavement,
/area/overmap_encounter/planetoid/wasteplanet/explored)
"bL" = (
/obj/structure/barricade/sandbags,
/obj/effect/turf_decal/road{
	dir = 1
	},
/obj/effect/turf_decal/road/stripes,
/turf/open/floor/concrete/pavement,
/area/overmap_encounter/planetoid/wasteplanet/explored)
"bM" = (
/obj/effect/turf_decal/road{
	dir = 1
	},
/turf/open/floor/concrete/pavement,
/area/overmap_encounter/planetoid/wasteplanet/explored)
"bT" = (
/obj/item/reagent_containers/glass/bucket,
/turf/open/floor/plating/asteroid/wasteplanet,
/area/overmap_encounter/planetoid/wasteplanet/explored)
"ck" = (
/obj/effect/turf_decal/road/line/opaque/yellow,
/obj/structure/barricade/sandbags,
/turf/open/floor/concrete/pavement,
/area/overmap_encounter/planetoid/wasteplanet/explored)
"cE" = (
/obj/effect/turf_decal/road/line/edge/opaque/yellow{
	dir = 4
	},
/obj/effect/decal/cleanable/dirt,
/turf/open/floor/concrete/pavement,
/area/overmap_encounter/planetoid/wasteplanet/explored)
"cL" = (
/obj/effect/decal/cleanable/dirt,
/turf/open/floor/concrete/slab_1,
/area/overmap_encounter/planetoid/wasteplanet/explored)
"dm" = (
/obj/effect/turf_decal/road/line/opaque/yellow,
/obj/effect/decal/cleanable/dirt,
/obj/effect/decal/cleanable/dirt,
/turf/open/floor/concrete/pavement,
/area/overmap_encounter/planetoid/wasteplanet/explored)
"dp" = (
/obj/structure/flippedtable,
/turf/open/floor/concrete,
/area/ruin/unpowered)
"dt" = (
/obj/structure/barricade/sandbags,
/obj/effect/turf_decal/road{
	dir = 4
	},
/obj/effect/decal/cleanable/dirt,
/turf/open/floor/concrete/pavement,
/area/overmap_encounter/planetoid/wasteplanet/explored)
"du" = (
/turf/open/floor/concrete,
/area/overmap_encounter/planetoid/wasteplanet/explored)
"dD" = (
/turf/open/floor/plating/asteroid/wasteplanet,
/area/overmap_encounter/planetoid/wasteplanet/explored)
"dY" = (
/obj/effect/turf_decal/road,
/obj/structure/barricade/sandbags,
/turf/open/floor/concrete/pavement,
/area/overmap_encounter/planetoid/wasteplanet/explored)
"et" = (
/obj/structure/barricade/sandbags,
/obj/effect/turf_decal/road,
/obj/effect/turf_decal/road/stripes,
/turf/open/floor/concrete/pavement,
/area/overmap_encounter/planetoid/wasteplanet/explored)
"ff" = (
/turf/open/floor/concrete,
/area/ruin/unpowered)
"fD" = (
/obj/effect/turf_decal/number/one{
	dir = 1
	},
/turf/open/floor/concrete,
/area/overmap_encounter/planetoid/wasteplanet/explored)
"gf" = (
/obj/structure/fence{
	dir = 8
	},
/turf/open/floor/plating/asteroid/wasteplanet,
/area/overmap_encounter/planetoid/wasteplanet/explored)
"gu" = (
/obj/effect/turf_decal/industrial/hatch,
/turf/open/floor/concrete,
/area/overmap_encounter/planetoid/wasteplanet/explored)
"gA" = (
/obj/structure/marker_beacon,
/obj/effect/decal/cleanable/dirt,
/turf/open/floor/concrete,
/area/overmap_encounter/planetoid/wasteplanet/explored)
"hi" = (
/obj/effect/turf_decal/road/line/opaque/yellow{
	dir = 1
	},
/turf/open/floor/concrete/pavement,
/area/overmap_encounter/planetoid/wasteplanet/explored)
"hH" = (
/obj/structure/barricade/sandbags,
/turf/open/floor/plating/asteroid/wasteplanet,
/area/overmap_encounter/planetoid/wasteplanet/explored)
"hN" = (
/obj/effect/turf_decal/road,
/turf/open/floor/concrete/pavement,
/area/overmap_encounter/planetoid/wasteplanet/explored)
"hX" = (
/obj/effect/turf_decal/number/one{
	dir = 1
	},
/turf/open/floor/plating/asteroid/wasteplanet,
/area/overmap_encounter/planetoid/wasteplanet/explored)
"iW" = (
/obj/structure/fence/corner{
	dir = 10
	},
/turf/open/floor/plating/asteroid/wasteplanet,
/area/overmap_encounter/planetoid/wasteplanet/explored)
"jb" = (
/obj/effect/turf_decal/road{
	dir = 4
	},
/obj/effect/decal/cleanable/dirt,
/turf/open/floor/concrete/pavement,
/area/overmap_encounter/planetoid/wasteplanet/explored)
"jk" = (
/obj/structure/barricade/sandbags,
/turf/open/floor/concrete/slab_1,
/area/overmap_encounter/planetoid/wasteplanet/explored)
"jQ" = (
/obj/effect/turf_decal/road{
	dir = 1
	},
/obj/item/clothing/head/helmet,
/turf/open/floor/concrete/pavement,
/area/overmap_encounter/planetoid/wasteplanet/explored)
"kI" = (
/obj/effect/turf_decal/road/line/opaque/yellow{
	dir = 1
	},
/obj/structure/barricade/sandbags,
/turf/open/floor/concrete/pavement,
/area/overmap_encounter/planetoid/wasteplanet/explored)
"lD" = (
/obj/effect/turf_decal/road/line/opaque/yellow{
	dir = 8
	},
/obj/structure/barricade/sandbags,
/turf/open/floor/concrete/pavement,
/area/overmap_encounter/planetoid/wasteplanet/explored)
"ma" = (
/obj/machinery/light/dim/directional/west,
/turf/open/floor/concrete,
/area/ruin/unpowered)
"mk" = (
/obj/effect/decal/cleanable/dirt/dust,
/turf/open/floor/concrete,
/area/ruin/unpowered)
"mM" = (
/obj/machinery/door/airlock/engineering,
/obj/effect/mapping_helpers/airlock/locked,
/turf/open/floor/concrete,
/area/ruin/unpowered)
"mS" = (
/obj/effect/turf_decal/road/line/opaque/yellow,
/obj/effect/decal/cleanable/dirt,
/turf/open/floor/concrete/pavement,
/area/overmap_encounter/planetoid/wasteplanet/explored)
"ne" = (
/obj/effect/turf_decal/road,
/obj/effect/decal/cleanable/dirt,
/turf/open/floor/concrete/pavement,
/area/overmap_encounter/planetoid/wasteplanet/explored)
"nY" = (
/obj/effect/turf_decal/road/line/edge/opaque/yellow{
	dir = 8
	},
/obj/effect/decal/cleanable/dirt,
/obj/item/clothing/head/helmet,
/turf/open/floor/concrete/pavement,
/area/overmap_encounter/planetoid/wasteplanet/explored)
"nZ" = (
/obj/effect/turf_decal/road{
	dir = 9
	},
/turf/open/floor/concrete/pavement,
/area/overmap_encounter/planetoid/wasteplanet/explored)
"pA" = (
/obj/effect/turf_decal/road/line/edge/opaque/yellow{
	dir = 4
	},
/turf/open/floor/concrete/pavement,
/area/overmap_encounter/planetoid/wasteplanet/explored)
"qB" = (
/obj/effect/turf_decal/road/stop{
	dir = 4
	},
/turf/open/floor/concrete/pavement,
/area/overmap_encounter/planetoid/wasteplanet/explored)
"rb" = (
/obj/effect/turf_decal/industrial/warning{
	dir = 1
	},
/obj/effect/decal/cleanable/dirt/dust,
/turf/open/floor/concrete,
/area/ruin/unpowered)
"rr" = (
/obj/structure/marker_beacon,
/turf/open/floor/concrete,
/area/overmap_encounter/planetoid/wasteplanet/explored)
"rL" = (
/obj/structure/barricade/sandbags,
/obj/effect/turf_decal/road{
	dir = 8
	},
/turf/open/floor/concrete/pavement,
/area/overmap_encounter/planetoid/wasteplanet/explored)
"ub" = (
/obj/effect/turf_decal/siding/white{
	dir = 4
	},
/turf/open/floor/concrete,
/area/ruin/unpowered)
"uA" = (
/obj/machinery/door/poddoor/shutters,
/turf/open/floor/concrete/tiles,
/area/ruin/unpowered)
"uS" = (
/obj/effect/turf_decal/road{
	dir = 8
	},
/obj/effect/decal/cleanable/dirt,
/turf/open/floor/concrete/pavement,
/area/overmap_encounter/planetoid/wasteplanet/explored)
"vg" = (
/obj/effect/decal/cleanable/dirt,
/turf/open/floor/concrete,
/area/overmap_encounter/planetoid/wasteplanet/explored)
"vu" = (
/obj/effect/turf_decal/road{
	dir = 5
	},
/obj/effect/decal/cleanable/dirt,
/turf/open/floor/concrete/pavement,
/area/overmap_encounter/planetoid/wasteplanet/explored)
"wh" = (
/obj/machinery/light/dim/directional/east,
/turf/open/floor/concrete,
/area/ruin/unpowered)
"wr" = (
/obj/structure/fence/door,
/turf/open/floor/plating/asteroid/wasteplanet,
/area/overmap_encounter/planetoid/wasteplanet/explored)
"wH" = (
/obj/effect/decal/cleanable/dirt/dust,
/turf/open/floor/concrete/slab_1,
/area/overmap_encounter/planetoid/wasteplanet/explored)
"wJ" = (
/obj/effect/turf_decal/road/line/edge/opaque/yellow{
	dir = 1
	},
/obj/effect/decal/cleanable/dirt,
/turf/open/floor/plating/asteroid/wasteplanet,
/area/overmap_encounter/planetoid/wasteplanet/explored)
"wR" = (
/obj/structure/table,
/obj/item/weldingtool/hugetank/empty,
/obj/effect/decal/cleanable/dirt/dust,
/obj/effect/decal/cleanable/dirt/dust,
/obj/effect/decal/cleanable/dirt/dust,
/turf/open/floor/concrete,
/area/ruin/unpowered)
"xv" = (
/obj/effect/turf_decal/road{
	dir = 4
	},
/turf/open/floor/concrete/pavement,
/area/overmap_encounter/planetoid/wasteplanet/explored)
"xF" = (
/obj/effect/turf_decal/industrial/warning{
	dir = 1
	},
/turf/open/floor/concrete,
/area/ruin/unpowered)
"xQ" = (
/turf/template_noop,
/area/template_noop)
"xZ" = (
/obj/effect/turf_decal/siding/white{
	dir = 4
	},
/obj/effect/decal/cleanable/dirt/dust,
/turf/open/floor/concrete,
/area/ruin/unpowered)
"yn" = (
/obj/effect/turf_decal/road/line/edge/opaque/yellow,
/obj/effect/decal/cleanable/dirt,
/turf/open/floor/concrete/pavement,
/area/overmap_encounter/planetoid/wasteplanet/explored)
"yv" = (
/obj/effect/turf_decal/industrial/warning{
	dir = 1
	},
/obj/effect/decal/cleanable/dirt/dust,
/obj/item/paper{
	info = "First, take a scoop out of the pit. Go ahead,d try it out! Second, mix it with raw cement. Then simply add some sand to it, doesn't matter. Then you got yourself some pavement. Simply pour it on some catwalk and you got yourself some roadway. More efficent this way too. Enjoy. On a side note, I hear something outside, better check that out. I'll finish his later."
	},
/turf/open/floor/concrete,
/area/ruin/unpowered)
"AB" = (
/obj/structure/fence/corner{
	dir = 4
	},
/turf/open/floor/plating/asteroid/wasteplanet,
/area/overmap_encounter/planetoid/wasteplanet/explored)
"AJ" = (
/obj/structure/fence,
/turf/open/floor/plating/asteroid/wasteplanet,
/area/overmap_encounter/planetoid/wasteplanet/explored)
"AQ" = (
/obj/effect/turf_decal/road/line/opaque/yellow,
/turf/open/floor/concrete/pavement,
/area/overmap_encounter/planetoid/wasteplanet/explored)
"AZ" = (
/obj/effect/turf_decal/road{
	dir = 8
	},
/obj/effect/turf_decal/road/stripes{
	dir = 8
	},
/turf/open/floor/concrete/pavement,
/area/overmap_encounter/planetoid/wasteplanet/explored)
"Bm" = (
/obj/effect/turf_decal/road/line/edge/opaque/yellow{
	dir = 4
	},
/obj/effect/decal/cleanable/blood/old,
/turf/open/floor/concrete/pavement,
/area/overmap_encounter/planetoid/wasteplanet/explored)
"BS" = (
/obj/structure/flippedtable,
/obj/effect/decal/cleanable/dirt/dust,
/turf/open/floor/concrete,
/area/ruin/unpowered)
"BZ" = (
/obj/effect/turf_decal/road/line/edge/opaque/yellow,
/obj/item/clothing/head/helmet,
/turf/open/floor/concrete/pavement,
/area/overmap_encounter/planetoid/wasteplanet/explored)
"Ct" = (
/obj/effect/turf_decal/number/one{
	dir = 1
	},
/obj/effect/decal/cleanable/dirt,
/turf/open/floor/concrete,
/area/overmap_encounter/planetoid/wasteplanet/explored)
"Cv" = (
/obj/effect/turf_decal/road{
	dir = 8
	},
/obj/effect/decal/cleanable/blood/old,
/turf/open/floor/concrete/pavement,
/area/overmap_encounter/planetoid/wasteplanet/explored)
"CC" = (
/obj/effect/decal/cleanable/blood/old,
/turf/open/floor/concrete/slab_1,
/area/overmap_encounter/planetoid/wasteplanet/explored)
"DA" = (
/obj/effect/turf_decal/road/line/edge/opaque/yellow{
	dir = 4
	},
/obj/item/clothing/head/helmet,
/turf/open/floor/concrete/pavement,
/area/overmap_encounter/planetoid/wasteplanet/explored)
"DI" = (
/obj/effect/turf_decal/road{
	dir = 4
	},
/obj/structure/barricade/sandbags,
/obj/effect/decal/cleanable/dirt,
/turf/open/floor/concrete/pavement,
/area/overmap_encounter/planetoid/wasteplanet/explored)
"DS" = (
/obj/effect/turf_decal/road/line/edge/opaque/yellow{
	dir = 8
	},
/obj/effect/decal/cleanable/dirt,
/turf/open/floor/concrete/pavement,
/area/overmap_encounter/planetoid/wasteplanet/explored)
"DZ" = (
/obj/effect/turf_decal/road{
	dir = 1
	},
/obj/effect/turf_decal/road/stripes,
/turf/open/floor/concrete/pavement,
/area/overmap_encounter/planetoid/wasteplanet/explored)
"Ff" = (
/obj/structure/sign/warning/fire{
	pixel_y = 32
	},
/obj/structure/reagent_dispensers/fueltank,
/obj/effect/decal/cleanable/dirt/dust,
/turf/open/floor/concrete,
/area/ruin/unpowered)
"Fp" = (
/obj/effect/turf_decal/road/line/edge/opaque/yellow,
/turf/open/floor/concrete/pavement,
/area/overmap_encounter/planetoid/wasteplanet/explored)
"FO" = (
/obj/effect/turf_decal/road/line/edge/opaque/yellow{
	dir = 1
	},
/turf/open/floor/concrete/pavement,
/area/overmap_encounter/planetoid/wasteplanet/explored)
"FV" = (
/obj/item/gun/ballistic/automatic/pistol/commander/no_mag,
/turf/open/floor/plating/asteroid/wasteplanet,
/area/overmap_encounter/planetoid/wasteplanet/explored)
"FW" = (
/obj/effect/turf_decal/road{
	dir = 8
	},
/obj/effect/turf_decal/road/stripes{
	dir = 4
	},
/turf/open/floor/concrete/pavement,
/area/overmap_encounter/planetoid/wasteplanet/explored)
"Gy" = (
/obj/effect/turf_decal/road/stripes{
	dir = 8
	},
/obj/effect/decal/cleanable/dirt,
/turf/open/floor/concrete/pavement,
/area/overmap_encounter/planetoid/wasteplanet/explored)
"Gz" = (
/obj/effect/turf_decal/road{
	dir = 4
	},
/obj/effect/turf_decal/road/stripes{
	dir = 4
	},
/turf/open/floor/concrete/pavement,
/area/overmap_encounter/planetoid/wasteplanet/explored)
"GJ" = (
/obj/effect/turf_decal/road/line/edge/opaque/yellow{
	dir = 4
	},
/obj/structure/barricade/sandbags,
/turf/open/floor/concrete/pavement,
/area/overmap_encounter/planetoid/wasteplanet/explored)
"GY" = (
/turf/open/floor/concrete/slab_1,
/area/overmap_encounter/planetoid/wasteplanet/explored)
"Ig" = (
/obj/effect/turf_decal/road{
	dir = 6
	},
/turf/open/floor/concrete/pavement,
/area/overmap_encounter/planetoid/wasteplanet/explored)
"IJ" = (
/obj/effect/turf_decal/road/stripes{
	dir = 8
	},
/turf/open/floor/concrete/pavement,
/area/overmap_encounter/planetoid/wasteplanet/explored)
"IK" = (
/obj/effect/turf_decal/road/stop{
	dir = 8
	},
/turf/open/floor/concrete/pavement,
/area/overmap_encounter/planetoid/wasteplanet/explored)
"IZ" = (
/obj/effect/decal/cleanable/dirt,
/turf/open/floor/plating/asteroid/wasteplanet,
/area/overmap_encounter/planetoid/wasteplanet/explored)
"Jl" = (
/obj/effect/turf_decal/road{
	dir = 1
	},
/obj/structure/barricade/sandbags,
/turf/open/floor/concrete/pavement,
/area/overmap_encounter/planetoid/wasteplanet/explored)
"JY" = (
/obj/effect/turf_decal/road/line/edge/opaque/yellow{
	dir = 1
	},
/obj/structure/barricade/sandbags,
/turf/open/floor/concrete/pavement,
/area/overmap_encounter/planetoid/wasteplanet/explored)
"Kh" = (
/obj/effect/turf_decal/road/stripes{
	dir = 4
	},
/turf/open/floor/concrete/pavement,
/area/overmap_encounter/planetoid/wasteplanet/explored)
"Kt" = (
/obj/effect/turf_decal/number/one,
/turf/open/floor/concrete,
/area/overmap_encounter/planetoid/wasteplanet/explored)
"Kx" = (
/obj/structure/fence/corner{
	dir = 9
	},
/turf/open/floor/plating/asteroid/wasteplanet,
/area/overmap_encounter/planetoid/wasteplanet/explored)
"KE" = (
/turf/open/floor/concrete/pavement,
/area/overmap_encounter/planetoid/wasteplanet/explored)
"KS" = (
/obj/effect/decal/cleanable/dirt,
/turf/open/floor/concrete/pavement,
/area/overmap_encounter/planetoid/wasteplanet/explored)
"KX" = (
/turf/closed/wall/concrete,
/area/ruin/unpowered)
"LT" = (
/obj/effect/turf_decal/road{
	dir = 4
	},
/obj/effect/turf_decal/road/stripes{
	dir = 8
	},
/turf/open/floor/concrete/pavement,
/area/overmap_encounter/planetoid/wasteplanet/explored)
"LY" = (
/obj/structure/barricade/sandbags,
/turf/open/floor/concrete,
/area/ruin/unpowered)
"LZ" = (
/obj/effect/turf_decal/road/line/opaque/yellow{
	dir = 1
	},
/obj/effect/decal/cleanable/dirt,
/turf/open/floor/concrete/pavement,
/area/overmap_encounter/planetoid/wasteplanet/explored)
"MS" = (
/obj/effect/turf_decal/road/line/opaque/yellow{
	dir = 8
	},
/turf/open/floor/concrete/pavement,
/area/overmap_encounter/planetoid/wasteplanet/explored)
"MY" = (
/obj/structure/table,
/obj/item/pickaxe/drill,
/obj/machinery/light/dim/directional/east,
/obj/effect/decal/cleanable/dirt/dust,
/turf/open/floor/concrete,
/area/ruin/unpowered)
"NM" = (
/obj/effect/turf_decal/road{
	dir = 8
	},
/turf/open/floor/concrete/pavement,
/area/overmap_encounter/planetoid/wasteplanet/explored)
"Oe" = (
/obj/structure/barricade/sandbags,
/obj/effect/turf_decal/road/stripes,
/turf/open/floor/concrete/pavement,
/area/overmap_encounter/planetoid/wasteplanet/explored)
"Om" = (
/obj/effect/turf_decal/road/line/edge/opaque/yellow{
	dir = 8
	},
/turf/open/floor/concrete/pavement,
/area/overmap_encounter/planetoid/wasteplanet/explored)
"Op" = (
/obj/effect/turf_decal/road/line/edge/opaque/yellow{
	dir = 4
	},
/obj/effect/turf_decal/road/stripes,
/turf/open/floor/concrete/pavement,
/area/overmap_encounter/planetoid/wasteplanet/explored)
"Ov" = (
/obj/structure/barricade/sandbags,
/obj/effect/turf_decal/road/stop,
/turf/open/floor/concrete/pavement,
/area/overmap_encounter/planetoid/wasteplanet/explored)
"PF" = (
/obj/effect/turf_decal/siding/white{
	dir = 4
	},
/obj/effect/decal/cleanable/dirt/dust,
/obj/effect/decal/cleanable/dirt/dust,
/turf/open/floor/concrete,
/area/ruin/unpowered)
"Qg" = (
/obj/effect/turf_decal/road{
	dir = 1
	},
/obj/item/grenade/frag,
/turf/open/floor/concrete/pavement,
/area/overmap_encounter/planetoid/wasteplanet/explored)
"Rg" = (
/obj/structure/fence/corner,
/turf/open/floor/plating/asteroid/wasteplanet,
/area/overmap_encounter/planetoid/wasteplanet/explored)
"RJ" = (
/turf/open/water/tar,
/area/overmap_encounter/planetoid/wasteplanet/explored)
"RT" = (
/obj/structure/table,
/obj/effect/decal/cleanable/dirt/dust,
/turf/open/floor/concrete,
/area/ruin/unpowered)
"RU" = (
/obj/effect/turf_decal/road{
	dir = 8
	},
/obj/structure/barricade/sandbags,
/turf/open/floor/concrete/pavement,
/area/overmap_encounter/planetoid/wasteplanet/explored)
"SE" = (
/obj/effect/turf_decal/road,
/obj/effect/turf_decal/road/stripes,
/turf/open/floor/concrete/pavement,
/area/overmap_encounter/planetoid/wasteplanet/explored)
"SF" = (
/obj/machinery/light/dim/directional/south,
/turf/open/floor/concrete,
/area/ruin/unpowered)
"SK" = (
/obj/vehicle/ridden/atv,
/obj/effect/turf_decal/siding/white{
	dir = 4
	},
/obj/machinery/light/dim/directional/west,
/obj/effect/decal/cleanable/dirt/dust,
/obj/effect/decal/cleanable/dirt/dust,
/turf/open/floor/concrete,
/area/ruin/unpowered)
"TU" = (
/obj/effect/turf_decal/road/edge,
/turf/open/floor/concrete/pavement,
/area/overmap_encounter/planetoid/wasteplanet/explored)
"Uf" = (
/obj/effect/turf_decal/road/line/opaque/yellow{
	dir = 1
	},
/obj/effect/decal/cleanable/blood/old,
/turf/open/floor/concrete/pavement,
/area/overmap_encounter/planetoid/wasteplanet/explored)
"Uj" = (
/obj/effect/turf_decal/road{
	dir = 4
	},
/turf/open/floor/plating/asteroid/wasteplanet,
/area/overmap_encounter/planetoid/wasteplanet/explored)
"UT" = (
/obj/effect/turf_decal/road/line/opaque/yellow{
	dir = 8
	},
/obj/effect/decal/cleanable/dirt,
/turf/open/floor/concrete/pavement,
/area/overmap_encounter/planetoid/wasteplanet/explored)
"Vn" = (
/obj/effect/turf_decal/road/line/opaque/yellow{
	dir = 4
	},
/turf/open/floor/concrete/pavement,
/area/overmap_encounter/planetoid/wasteplanet/explored)
"Vt" = (
/obj/effect/turf_decal/road/edge{
	dir = 1
	},
/obj/effect/decal/cleanable/dirt,
/turf/open/floor/concrete/pavement,
/area/overmap_encounter/planetoid/wasteplanet/explored)
"VD" = (
/obj/structure/table,
/turf/open/floor/concrete,
/area/ruin/unpowered)
"WT" = (
/obj/effect/turf_decal/road/line/edge/opaque/yellow{
	dir = 1
	},
/obj/effect/decal/cleanable/dirt,
/turf/open/floor/concrete/pavement,
/area/overmap_encounter/planetoid/wasteplanet/explored)
"XC" = (
/obj/effect/decal/cleanable/dirt/dust,
/obj/effect/decal/cleanable/dirt/dust,
/turf/open/floor/concrete,
/area/ruin/unpowered)
"ZI" = (
/obj/effect/turf_decal/road/line/edge/opaque/yellow{
	dir = 1
	},
/obj/effect/decal/cleanable/blood/old,
/obj/item/gun/ballistic/automatic/pistol/commander/no_mag,
/turf/open/floor/concrete/pavement,
/area/overmap_encounter/planetoid/wasteplanet/explored)

(1,1,1) = {"
xQ
xQ
xQ
xQ
xQ
xQ
xQ
xQ
xQ
xQ
xQ
xQ
xQ
xQ
xQ
xQ
xQ
xQ
xQ
xQ
xQ
xQ
xQ
xQ
xQ
xQ
xQ
dD
NM
xQ
"}
(2,1,1) = {"
xQ
xQ
xQ
xQ
xQ
xQ
xQ
xQ
xQ
xQ
xQ
xQ
xQ
xQ
xQ
xQ
xQ
xQ
xQ
xQ
xQ
xQ
xQ
GY
dD
dD
KE
dD
dD
GY
"}
(3,1,1) = {"
xQ
xQ
xQ
xQ
xQ
xQ
xQ
xQ
xQ
xQ
xQ
xQ
xQ
xQ
xQ
xQ
xQ
xQ
xQ
xQ
xQ
xQ
xQ
xQ
cL
jb
KS
dD
NM
dD
"}
(4,1,1) = {"
xQ
xQ
xQ
xQ
xQ
xQ
xQ
xQ
xQ
xQ
xQ
xQ
xQ
GY
dD
GY
GY
cL
dD
GY
GY
GY
xQ
GY
GY
Gz
Kh
qB
FW
GY
"}
(5,1,1) = {"
xQ
xQ
xQ
xQ
xQ
xQ
xQ
xQ
xQ
xQ
xQ
xQ
dD
nZ
hN
hN
hN
ne
ne
dD
hN
ne
ne
hN
et
TU
KE
KE
NM
GY
"}
(6,1,1) = {"
xQ
xQ
xQ
xQ
xQ
xQ
xQ
xQ
xQ
xQ
xQ
xQ
GY
xv
IZ
yn
Vn
Om
yn
Vn
nY
yn
Vn
dD
Ov
dD
KE
KS
uS
GY
"}
(7,1,1) = {"
xQ
xQ
xQ
xQ
xQ
xQ
xQ
xQ
xQ
xQ
xQ
xQ
cL
jb
KS
pA
MS
FO
pA
UT
wJ
pA
MS
ZI
Oe
KE
KE
KE
uS
dD
"}
(8,1,1) = {"
xQ
xQ
xQ
xQ
xQ
xQ
xQ
xQ
xQ
xQ
xQ
xQ
IZ
jb
Fp
Om
dD
Qg
bM
bM
bM
bM
bM
dD
bL
aP
KE
dD
NM
GY
"}
(9,1,1) = {"
xQ
Kx
AJ
AJ
AJ
AJ
AJ
AJ
AJ
AJ
AJ
iW
GY
jb
AQ
hi
NM
dD
GY
GY
dD
GY
GY
GY
GY
LT
IK
IJ
AZ
GY
"}
(10,1,1) = {"
xQ
gf
RJ
dD
dD
RJ
RJ
dD
bT
dD
dD
gf
GY
jb
pA
FO
NM
GY
gA
Ct
vg
du
Kt
rr
GY
xv
Fp
Om
uS
GY
"}
(11,1,1) = {"
xQ
gf
RJ
dD
RJ
RJ
RJ
RJ
dD
dD
dD
wr
GY
jb
Fp
dD
NM
GY
dD
du
vg
vg
du
gu
dD
xv
AQ
LZ
uS
dD
"}
(12,1,1) = {"
xQ
gf
RJ
RJ
RJ
RJ
RJ
RJ
RJ
dD
dD
gf
GY
DI
ck
kI
RU
hH
gu
du
vg
du
du
gu
GY
xv
cE
WT
NM
GY
"}
(13,1,1) = {"
xQ
gf
RJ
RJ
RJ
RJ
RJ
RJ
RJ
RJ
RJ
gf
GY
xv
Bm
WT
uS
jk
gu
du
vg
du
du
gu
cL
Uj
Fp
Om
NM
GY
"}
(14,1,1) = {"
xQ
gf
dD
RJ
RJ
RJ
RJ
RJ
RJ
RJ
dD
gf
dD
xv
BZ
DS
Cv
jk
rr
fD
vg
vg
Kt
rr
GY
jb
AQ
hi
NM
GY
"}
(15,1,1) = {"
xQ
gf
dD
RJ
RJ
RJ
RJ
RJ
RJ
RJ
dD
gf
GY
xv
AQ
hi
NM
jk
gu
du
du
vg
dD
gu
GY
jb
pA
FO
NM
dD
"}
(16,1,1) = {"
xQ
gf
RJ
RJ
RJ
RJ
RJ
RJ
RJ
RJ
dD
gf
GY
dD
pA
FO
FV
jk
gu
du
du
vg
vg
gu
GY
jb
yn
Om
NM
GY
"}
(17,1,1) = {"
xQ
gf
RJ
RJ
RJ
RJ
RJ
RJ
RJ
RJ
dD
gf
GY
xv
Fp
Om
NM
GY
gu
vg
du
du
du
gu
GY
xv
mS
dD
NM
GY
"}
(18,1,1) = {"
xQ
gf
RJ
RJ
RJ
RJ
RJ
RJ
RJ
RJ
RJ
gf
GY
xv
dm
hi
NM
GY
rr
Ct
du
du
Kt
rr
GY
xv
pA
FO
NM
GY
"}
(19,1,1) = {"
xQ
gf
dD
RJ
RJ
RJ
RJ
RJ
RJ
dD
dD
gf
GY
jb
cE
dD
NM
dD
gu
IZ
vg
du
du
gu
dD
jb
yn
DS
NM
dD
"}
(20,1,1) = {"
xQ
gf
RJ
RJ
RJ
RJ
RJ
RJ
bT
dD
bT
wr
cL
jb
Fp
Om
NM
cL
gu
du
dD
vg
dD
gu
GY
xv
AQ
hi
NM
cL
"}
(21,1,1) = {"
xQ
gf
dD
dD
dD
dD
dD
dD
RJ
dD
dD
gf
GY
jb
dD
LZ
uS
cL
gu
du
dD
du
du
gu
GY
xv
DA
FO
NM
cL
"}
(22,1,1) = {"
xQ
AB
AJ
AJ
AJ
AJ
AJ
AJ
AJ
AJ
AJ
Rg
cL
jb
pA
WT
NM
dD
rr
hX
du
dD
Kt
rr
dD
jb
yn
Om
NM
cL
"}
(23,1,1) = {"
KX
KX
KX
KX
KX
KX
KX
KX
GY
GY
cL
GY
GY
jb
Fp
DS
NM
GY
gu
dD
du
du
dD
dD
GY
jb
AQ
Uf
uS
cL
"}
(24,1,1) = {"
KX
SK
xZ
rb
mk
ma
LY
uA
SE
hN
ne
ne
dY
TU
AQ
hi
NM
GY
gu
du
dD
dD
du
gu
cL
dt
GJ
JY
rL
GY
"}
(25,1,1) = {"
KX
xZ
xZ
yv
XC
mk
LY
uA
aJ
Vn
Om
Fp
bB
Om
cE
WT
NM
cL
dD
dD
du
du
dD
gu
dD
xv
Fp
Om
NM
GY
"}
(26,1,1) = {"
KX
xZ
PF
rb
VD
BS
LY
uA
Op
MS
FO
pA
lD
FO
KS
KE
NM
cL
dD
fD
dD
dD
Kt
rr
dD
dD
AQ
hi
NM
dD
"}
(27,1,1) = {"
KX
ub
xZ
xF
RT
dp
LY
uA
DZ
bM
bM
bM
Jl
Vt
KE
KE
NM
cL
gu
dD
xQ
xQ
dD
gu
GY
xv
pA
WT
uS
cL
"}
(28,1,1) = {"
KX
Ff
mk
xF
wR
dp
SF
KX
CC
GY
wH
GY
CC
LT
IJ
Gy
AZ
GY
dD
xQ
xQ
xQ
xQ
gu
dD
dD
Fp
dD
NM
GY
"}
(29,1,1) = {"
KX
MY
ff
xF
ff
wh
mk
mM
wH
wH
wH
GY
GY
vu
jQ
bM
Ig
GY
gu
du
xQ
xQ
du
xQ
xQ
xv
dD
hi
dD
dD
"}
(30,1,1) = {"
KX
KX
KX
KX
KX
KX
KX
KX
GY
GY
wH
GY
cL
cL
cL
cL
GY
GY
xQ
xQ
xQ
xQ
xQ
xQ
xQ
xQ
pA
dD
KE
GY
"}
