//MAP CONVERTED BY dmm2tgm.py THIS HEADER COMMENT PREVENTS RECONVERSION, DO NOT REMOVE
"ao" = (
/obj/machinery/atmospherics/components/unary/vent_scrubber/on/layer4,
/turf/open/floor/plasteel/dark,
/area/ship/bridge)
"cu" = (
/obj/structure/cable{
	icon_state = "4-8"
	},
/obj/machinery/atmospherics/pipe/manifold/scrubbers/hidden/layer4,
/obj/machinery/atmospherics/pipe/manifold/supply/hidden/layer2{
	dir = 1
	},
/obj/machinery/holopad/emergency/command,
/turf/open/floor/plasteel/dark,
/area/ship/bridge)
"cH" = (
/obj/structure/cable{
	icon_state = "4-8"
	},
/obj/structure/cable{
	icon_state = "2-4"
	},
/obj/machinery/light/small/directional/north,
/obj/effect/turf_decal/number/three{
	dir = 4
	},
/obj/merge_conflict_marker{
	name = "---Merge Conflict Marker---",
	desc = "A best-effort merge was performed. You must resolve this conflict yourself (manually) and remove this object once complete."
	},
/obj/structure/cable{
	icon_state = "4-8"
	},
/obj/structure/cable{
	icon_state = "2-4"
	},
/obj/machinery/light/small/directional/north,
/turf/open/floor/plating,
/area/ship/engineering)
"dx" = (
/obj/structure/cable{
	icon_state = "1-2"
	},
/obj/structure/cable{
	icon_state = "2-8"
	},
/obj/machinery/atmospherics/pipe/simple/green{
	dir = 6
	},
/obj/effect/turf_decal/number/zero{
	dir = 4
	},
/turf/open/floor/plating,
/area/ship/engineering)
"dJ" = (
/turf/closed/wall/mineral/plastitanium/nodiagonal,
/area/ship/engineering)
"ej" = (
/obj/machinery/atmospherics/pipe/simple/purple{
	dir = 10
	},
/obj/structure/reagent_dispensers/fueltank,
/turf/open/floor/plating,
/area/ship/engineering)
"em" = (
/obj/machinery/power/terminal{
	dir = 8
	},
/obj/structure/cable{
	icon_state = "0-4"
	},
/obj/machinery/door/firedoor/border_only{
	dir = 8
	},
/obj/machinery/atmospherics/pipe/simple/purple{
	dir = 6
	},
/obj/machinery/portable_atmospherics/canister/air,
/obj/effect/turf_decal/industrial/warning{
	dir = 8
	},
/turf/open/floor/plating,
/area/ship/engineering)
"hc" = (
/obj/structure/cable{
	icon_state = "1-8"
	},
/obj/machinery/button/door{
	color = "#ddcc00";
	dir = 8;
	id = "masi_engi";
	name = "engine emergency shielding";
	pixel_x = 25
	},
/turf/open/floor/plating,
/area/ship/engineering)
"ic" = (
/obj/machinery/autolathe,
/turf/open/floor/plating,
/area/ship/engineering)
"ie" = (
/obj/structure/cable{
	icon_state = "2-8"
	},
/obj/machinery/atmospherics/components/trinary/filter/atmos/flipped/n2,
/obj/machinery/button/door{
	color = "#ddcc00";
	dir = 8;
	id = "masi_engi";
	name = "engine emergency shielding";
	pixel_x = 25
	},
/turf/open/floor/plating,
/area/ship/engineering)
"if" = (
/obj/machinery/atmospherics/pipe/layer_manifold/visible,
/turf/closed/wall/mineral/plastitanium/nodiagonal,
/area/ship/engineering)
"ip" = (
/obj/structure/cable{
	icon_state = "4-8"
	},
/obj/structure/cable{
	icon_state = "2-4"
	},
/obj/machinery/atmospherics/pipe/manifold/supply/hidden/layer2{
	dir = 1
	},
/obj/machinery/atmospherics/pipe/manifold/scrubbers/hidden/layer4,
/obj/effect/landmark/observer_start,
/turf/open/floor/plasteel/dark,
/area/ship/bridge)
"ix" = (
/obj/structure/cable{
	icon_state = "1-2"
	},
/obj/machinery/door/firedoor/border_only{
	dir = 1
	},
/obj/machinery/door/firedoor/border_only,
/obj/machinery/door/airlock/external/glass{
	name = "Internal Airlock"
	},
/turf/open/floor/plating,
/area/ship/engineering)
"ju" = (
/obj/docking_port/mobile{
	dir = 2;
	launch_status = 0;
	port_direction = 8
	},
/obj/effect/mapping_helpers/airlock/locked,
/obj/machinery/door/airlock/hatch{
	name = "External Maintenance Hatch"
	},
/turf/open/floor/plating,
/area/ship/engineering)
"kK" = (
/obj/structure/cable{
	icon_state = "1-8"
	},
/obj/structure/closet/crate{
	color = "#ffcc00";
	name = "spare fuel crate"
	},
/obj/item/stack/sheet/mineral/plasma/twenty,
/obj/item/stack/sheet/mineral/uranium/twenty,
/obj/effect/turf_decal/number/five{
	dir = 4
	},
/turf/open/floor/plating,
/area/ship/engineering)
"kO" = (
/obj/structure/fans/tiny{
	pixel_y = -10
	},
/obj/effect/turf_decal/industrial/stand_clear{
	dir = 1;
	layer = 2.09
	},
/obj/machinery/button/door{
	dir = 8;
	id = "masinyane_blastdoors";
	pixel_x = 23
	},
/obj/machinery/door/poddoor{
	id = "masinyane_blastdoors";
	name = "Masinyane Entrance Doors"
	},
/turf/open/floor/plasteel/tech,
/area/ship/bridge)
"kS" = (
/turf/open/floor/plating,
/area/ship/engineering)
"lt" = (
/obj/structure/chair/comfy/shuttle{
	dir = 4
	},
/obj/item/radio/intercom/wideband/directional/north,
/obj/machinery/button/door{
	id = "masinyane_windowshield";
	name = "shutters";
	pixel_x = 25;
	pixel_y = 21
	},
/obj/item/radio/intercom/directional/north{
	pixel_y = 44
	},
/obj/merge_conflict_marker{
	name = "---Merge Conflict Marker---",
	desc = "A best-effort merge was performed. You must resolve this conflict yourself (manually) and remove this object once complete."
	},
/obj/structure/chair/comfy/shuttle{
	dir = 4
	},
/obj/item/radio/intercom/wideband/directional/north,
/obj/machinery/button/door{
	id = "masinyane_windowshield";
	name = "shutters";
	pixel_x = 25;
	pixel_y = 30
	},
/obj/item/radio/intercom/directional/north{
	pixel_y = 36
	},
/turf/open/floor/mineral/plastitanium,
/area/ship/bridge)
"oa" = (
/obj/structure/cable{
	icon_state = "4-8"
	},
/obj/structure/cable{
	icon_state = "1-4"
	},
/obj/machinery/atmospherics/pipe/manifold/green{
	dir = 8
	},
/obj/machinery/light/small/directional/south,
/obj/effect/turf_decal/number/five{
	dir = 4
	},
/obj/merge_conflict_marker{
	name = "---Merge Conflict Marker---",
	desc = "A best-effort merge was performed. You must resolve this conflict yourself (manually) and remove this object once complete."
	},
/obj/structure/cable{
	icon_state = "4-8"
	},
/obj/structure/cable{
	icon_state = "1-4"
	},
/obj/machinery/atmospherics/pipe/manifold/green{
	dir = 8
	},
/obj/machinery/light/small/directional/south,
/turf/open/floor/plating,
/area/ship/engineering)
"pQ" = (
/obj/structure/cable{
	icon_state = "4-8"
	},
/obj/machinery/door/firedoor/border_only{
	dir = 4
	},
/obj/machinery/door/firedoor/border_only{
	dir = 8
	},
/obj/machinery/door/airlock/hatch{
	name = "Thruster Maintenance";
	dir = 4
	},
/obj/machinery/atmospherics/pipe/simple/scrubbers/hidden/layer4{
	dir = 4
	},
/obj/machinery/atmospherics/pipe/simple/supply/hidden/layer2{
	dir = 4
	},
/turf/open/floor/plating,
/area/ship/engineering)
"qu" = (
/obj/machinery/door/firedoor/border_only,
/obj/machinery/door/firedoor/border_only{
	dir = 1
	},
/obj/machinery/door/airlock/grunge{
	name = "Cockpit"
	},
/turf/open/floor/mineral/plastitanium,
/area/ship/bridge)
"qJ" = (
/obj/structure/cable{
	icon_state = "1-2"
	},
/obj/structure/cable{
	icon_state = "1-8"
	},
/obj/effect/turf_decal/number/zero{
	dir = 4
	},
/turf/open/floor/plating,
/area/ship/engineering)
"ri" = (
/obj/machinery/computer/helm{
	dir = 8
	},
/obj/machinery/light/directional/north,
/turf/open/floor/mineral/plastitanium,
/area/ship/bridge)
"sn" = (
/turf/open/floor/plasteel/tech,
/area/ship/bridge)
"sx" = (
/turf/template_noop,
/area/template_noop)
"tx" = (
/obj/machinery/atmospherics/components/unary/passive_vent{
	dir = 4
	},
/obj/effect/turf_decal/industrial/warning/full,
/turf/open/floor/plating,
/area/ship/engineering)
"up" = (
/obj/effect/turf_decal/industrial/warning{
	dir = 1
	},
/turf/open/floor/plasteel/tech,
/area/ship/bridge)
"ve" = (
/obj/machinery/power/terminal{
	dir = 8
	},
/obj/structure/cable{
	icon_state = "0-4"
	},
/obj/machinery/door/firedoor/border_only{
	dir = 8
	},
/obj/effect/turf_decal/industrial/warning{
	dir = 8
	},
/turf/open/floor/plating,
/area/ship/engineering)
"vC" = (
/obj/structure/cable,
/obj/machinery/power/port_gen/pacman/mrs{
	anchored = 1
	},
/obj/effect/turf_decal/trimline/opaque/white/filled/warning{
	dir = 1
	},
/turf/open/floor/plasteel/dark,
/area/ship/bridge)
"vD" = (
/obj/structure/cable,
/obj/machinery/power/port_gen/pacman/super{
	anchored = 1
	},
/obj/effect/turf_decal/trimline/opaque/white/filled/warning{
	dir = 1
	},
/obj/machinery/airalarm/directional/east{
	name = "air filtration controller"
	},
/turf/open/floor/plasteel/dark,
/area/ship/bridge)
"wq" = (
/obj/effect/turf_decal/industrial/warning{
	dir = 1
	},
/obj/machinery/light/directional/west,
/turf/open/floor/plasteel/tech,
/area/ship/bridge)
"yn" = (
/obj/machinery/door/firedoor/border_only{
	dir = 1
	},
/obj/machinery/door/firedoor/border_only,
/obj/machinery/door/airlock/external/glass{
	name = "Internal Airlock"
	},
/turf/open/floor/plasteel/tech,
/area/ship/bridge)
"yJ" = (
/obj/structure/cable{
	icon_state = "1-2"
	},
/obj/structure/cable{
	icon_state = "1-8"
	},
/obj/machinery/firealarm/directional/east,
/obj/effect/turf_decal/isf_small/left{
	dir = 4
	},
/obj/merge_conflict_marker{
	name = "---Merge Conflict Marker---",
	desc = "A best-effort merge was performed. You must resolve this conflict yourself (manually) and remove this object once complete."
	},
/obj/structure/cable{
	icon_state = "1-2"
	},
/obj/structure/cable{
	icon_state = "1-8"
	},
/obj/machinery/light/small/directional/east,
/obj/machinery/firealarm/directional/east,
/turf/open/floor/plating,
/area/ship/engineering)
"zI" = (
/obj/structure/cable{
	icon_state = "2-4"
	},
/obj/machinery/atmospherics/components/unary/vent_pump/on/layer2{
	dir = 1
	},
/turf/open/floor/plasteel/dark,
/area/ship/bridge)
"Cu" = (
/obj/machinery/door/window/northright,
/obj/machinery/mineral/ore_redemption,
/obj/machinery/door/firedoor/border_only,
/turf/open/floor/plating,
/area/ship/bridge)
"Cy" = (
/obj/machinery/power/terminal{
	dir = 8
	},
/obj/structure/cable{
	icon_state = "0-4"
	},
/obj/machinery/atmospherics/pipe/simple/supply/hidden/layer2,
/obj/machinery/door/firedoor/border_only{
	dir = 8
	},
/obj/machinery/button/door{
	color = "#ddcc00";
	id = "masi_engi";
	name = "engine emergency shielding";
	pixel_x = 5;
	pixel_y = 32
	},
/obj/effect/turf_decal/industrial/warning{
	dir = 8
	},
/turf/open/floor/plating,
/area/ship/engineering)
"Ep" = (
/obj/structure/window/plasma/reinforced/spawner/west,
/obj/machinery/power/smes/shuttle/precharged{
	dir = 4
	},
/obj/structure/cable{
	icon_state = "0-8"
	},
/obj/machinery/door/poddoor/preopen{
	dir = 4;
	id = "masi_engi";
	name = "Emergency Engine Shielding"
	},
/turf/open/floor/plating,
/area/ship/engineering)
"EK" = (
/obj/machinery/atmospherics/pipe/simple/purple{
	dir = 9
	},
/turf/closed/wall/mineral/plastitanium/nodiagonal,
/area/ship/engineering)
"Fo" = (
/obj/structure/cable{
	icon_state = "1-2"
	},
/obj/structure/cable{
	icon_state = "4-8"
	},
/obj/structure/cable{
	icon_state = "2-4"
	},
/obj/structure/cable{
	icon_state = "1-4"
	},
/obj/machinery/atmospherics/pipe/simple/scrubbers/hidden/layer4{
	dir = 5
	},
/obj/machinery/atmospherics/pipe/simple/supply/hidden/layer2{
	dir = 4
	},
/obj/effect/turf_decal/isf_small{
	dir = 4
	},
/turf/open/floor/plating,
/area/ship/engineering)
"Ho" = (
/obj/machinery/power/terminal{
	dir = 8
	},
/obj/structure/cable{
	icon_state = "0-4"
	},
/obj/machinery/atmospherics/components/unary/portables_connector/visible/layer2{
	dir = 1
	},
/obj/machinery/door/firedoor/border_only{
	dir = 8
	},
/obj/effect/turf_decal/industrial/warning{
	dir = 8
	},
/obj/machinery/light/small/directional/south,
/turf/open/floor/plating,
/area/ship/engineering)
"Hu" = (
/obj/machinery/cryopod{
	dir = 4
	},
/obj/machinery/computer/cryopod/directional/west,
/obj/merge_conflict_marker{
	name = "---Merge Conflict Marker---",
	desc = "A best-effort merge was performed. You must resolve this conflict yourself (manually) and remove this object once complete."
	},
/obj/machinery/cryopod{
	dir = 4
	},
/obj/machinery/computer/cryopod{
	dir = 4;
	pixel_x = -25
	},
/obj/machinery/light/directional/west,
/turf/open/floor/mineral/plastitanium,
/area/ship/bridge)
"HV" = (
/obj/structure/cable{
	icon_state = "1-2"
	},
/obj/structure/cable{
	icon_state = "2-8"
	},
/obj/machinery/power/apc/auto_name/directional/east,
/obj/structure/cable{
	icon_state = "0-2"
	},
/obj/machinery/atmospherics/pipe/simple/scrubbers/hidden/layer4,
/obj/effect/turf_decal/isf_small/right{
	dir = 4
	},
/turf/open/floor/plating,
/area/ship/engineering)
"Iu" = (
/obj/structure/fans/tiny{
	pixel_y = -10
	},
/obj/effect/turf_decal/industrial/stand_clear{
	layer = 2.09
	},
/obj/machinery/button/door{
	dir = 4;
	id = "masinyane_blastdoors";
	pixel_x = -23
	},
/obj/machinery/door/poddoor{
	id = "masinyane_blastdoors";
	name = "Masinyane Entrance Doors"
	},
/turf/open/floor/plasteel/tech,
/area/ship/bridge)
"Iw" = (
/obj/effect/turf_decal/industrial/warning/corner{
	dir = 1
	},
/obj/structure/tank_dispenser/oxygen,
/turf/open/floor/plasteel/tech,
/area/ship/bridge)
"Kt" = (
/obj/effect/turf_decal/industrial/warning,
/obj/machinery/light/small/directional/east,
/turf/open/floor/plating,
/area/ship/bridge)
"KV" = (
/obj/item/areaeditor/shuttle,
/obj/item/pipe_dispenser,
/obj/item/clothing/gloves/color/yellow,
/obj/item/gps{
	gpstag = "MasinyaneVessel"
	},
/obj/item/storage/firstaid/regular,
/obj/structure/closet/wall/blue{
	dir = 4;
	name = "Equipment closet";
	pixel_x = -30
	},
/obj/item/inducer/sci{
	cell_type = /obj/item/stock_parts/cell/high
	},
/obj/item/circuitboard/machine/cell_charger,
/obj/item/circuitboard/machine/chem_dispenser/drinks,
/turf/open/floor/mineral/plastitanium,
/area/ship/bridge)
"LT" = (
/obj/structure/cable{
	icon_state = "2-4"
	},
/obj/structure/cable{
	icon_state = "4-8"
	},
/obj/machinery/atmospherics/components/unary/vent_pump/on/layer2{
	dir = 1
	},
/obj/structure/chair{
	dir = 1
	},
/turf/open/floor/plasteel/dark,
/area/ship/bridge)
"Md" = (
/obj/effect/spawner/structure/window/plasma/reinforced/plastitanium,
/obj/machinery/door/poddoor{
	id = "masinyane_windowshield";
	name = "Cockpit Emergency Blast Door"
	},
/turf/open/floor/plating,
/area/ship/bridge)
"Mj" = (
/obj/structure/cable{
	icon_state = "1-2"
	},
/obj/machinery/door/firedoor/border_only{
	dir = 1
	},
/obj/machinery/door/firedoor/border_only,
/obj/machinery/atmospherics/pipe/layer_manifold/visible,
/obj/machinery/door/airlock/external/glass{
	name = "Internal Airlock"
	},
/turf/open/floor/plating,
/area/ship/engineering)
"Ng" = (
/obj/machinery/atmospherics/pipe/simple/purple{
	dir = 4
	},
/turf/closed/wall/mineral/plastitanium/nodiagonal,
/area/ship/engineering)
"Pe" = (
/obj/machinery/atmospherics/components/trinary/filter/atmos/flipped/o2,
/obj/machinery/firealarm/directional/east,
/obj/structure/closet/crate/freezer,
/obj/item/reagent_containers/food/snacks/burrito,
/obj/item/reagent_containers/food/snacks/burrito,
/obj/item/reagent_containers/food/snacks/burrito,
/obj/item/reagent_containers/food/snacks/burrito,
/obj/item/reagent_containers/food/snacks/burrito,
/obj/item/reagent_containers/food/snacks/burrito,
/obj/item/reagent_containers/food/snacks/burrito,
/obj/item/reagent_containers/food/snacks/burrito,
/obj/item/reagent_containers/food/snacks/burrito,
/obj/item/reagent_containers/food/snacks/burrito,
/obj/item/reagent_containers/food/snacks/burrito,
/obj/item/reagent_containers/food/snacks/burrito,
/turf/open/floor/plating,
/area/ship/engineering)
"PB" = (
/obj/machinery/button/door{
	color = "#ddcc00";
	dir = 4;
	id = "masi_engi";
	name = "engine emergency shielding";
	pixel_x = -23
	},
/turf/open/floor/plasteel/dark,
/area/ship/bridge)
"Qn" = (
/obj/structure/extinguisher_cabinet/directional/north,
/obj/machinery/atmospherics/components/unary/vent_scrubber/on/layer4,
/obj/structure/chair,
/turf/open/floor/plasteel/dark,
/area/ship/bridge)
"QR" = (
/obj/structure/rack,
/obj/item/t_scanner/adv_mining_scanner/lesser,
/obj/item/t_scanner/adv_mining_scanner/lesser,
/obj/item/t_scanner/adv_mining_scanner/lesser,
/obj/item/storage/bag/ore,
/obj/item/storage/bag/ore,
/obj/item/storage/bag/ore,
/obj/item/pickaxe/drill,
/obj/item/gun/energy/plasmacutter,
/obj/item/gun/energy/plasmacutter,
/turf/open/floor/plasteel/tech,
/area/ship/bridge)
"Rr" = (
/obj/structure/cable{
	icon_state = "1-2"
	},
/obj/structure/cable{
	icon_state = "2-8"
	},
/obj/machinery/atmospherics/pipe/simple/purple{
	dir = 4
	},
/obj/machinery/portable_atmospherics/canister/air,
/obj/effect/turf_decal/number/three{
	dir = 4
	},
/turf/open/floor/plating,
/area/ship/engineering)
"Rt" = (
/obj/structure/cable{
	icon_state = "4-8"
	},
/obj/machinery/atmospherics/pipe/simple/scrubbers/hidden/layer4{
	dir = 9
	},
/obj/machinery/atmospherics/pipe/simple/supply/hidden/layer2{
	dir = 10
	},
/obj/structure/table/glass,
/turf/open/floor/plasteel/dark,
/area/ship/bridge)
"So" = (
/obj/machinery/atmospherics/components/unary/vent_scrubber/on/layer4,
/obj/item/radio/intercom/directional/west,
/turf/open/floor/plasteel/dark,
/area/ship/bridge)
"St" = (
/obj/machinery/power/terminal{
	dir = 8
	},
/obj/structure/cable{
	icon_state = "0-4"
	},
/obj/machinery/atmospherics/pipe/manifold/supply/hidden/layer2{
	dir = 8
	},
/obj/machinery/door/firedoor/border_only{
	dir = 8
	},
/obj/effect/turf_decal/industrial/warning{
	dir = 8
	},
/turf/open/floor/plating,
/area/ship/engineering)
"SR" = (
/obj/machinery/door/window/westright,
/obj/structure/window,
/obj/structure/rack,
/obj/item/clothing/suit/space/hardsuit/mining/independent{
	pixel_x = 4;
	pixel_y = -4
	},
/obj/item/clothing/suit/space/hardsuit/mining/independent,
/obj/item/clothing/suit/space/hardsuit/mining/independent{
	pixel_x = -4;
	pixel_y = 4
	},
/turf/open/floor/plasteel/dark,
/area/ship/bridge)
"TB" = (
/obj/structure/cable{
	icon_state = "0-4"
	},
/obj/machinery/power/shuttle/engine/electric/premium{
	dir = 4
	},
/turf/open/floor/plating,
/area/ship/engineering)
"Uc" = (
/obj/machinery/power/smes/engineering,
/obj/machinery/light/directional/east,
/obj/structure/cable{
	icon_state = "0-8"
	},
/obj/effect/turf_decal/trimline/opaque/white/filled/warning{
	dir = 10
	},
/obj/merge_conflict_marker{
	name = "---Merge Conflict Marker---",
	desc = "A best-effort merge was performed. You must resolve this conflict yourself (manually) and remove this object once complete."
	},
/obj/machinery/power/smes/engineering,
/obj/machinery/light/directional/east,
/obj/structure/cable{
	icon_state = "0-8"
	},
/obj/effect/turf_decal/trimline/opaque/white/filled/warning{
	dir = 10
	},
/obj/item/storage/secure/safe{
	pixel_x = 33
	},
/turf/open/floor/plasteel/dark,
/area/ship/bridge)
"Uu" = (
/obj/machinery/power/apc/auto_name/directional/west,
/obj/structure/cable,
/obj/machinery/atmospherics/components/unary/vent_pump/on/layer2{
	dir = 1
	},
/turf/open/floor/plasteel/dark,
/area/ship/bridge)
"Vd" = (
/obj/effect/spawner/structure/window/plasma/reinforced/plastitanium,
/obj/machinery/door/poddoor{
	dir = 4;
	id = "masinyane_windowshield";
	name = "Cockpit Emergency Blast Door"
	},
/turf/open/floor/plating,
/area/ship/bridge)
"VA" = (
/obj/effect/turf_decal/industrial/warning,
/obj/machinery/light/small/directional/west,
/turf/open/floor/plating,
/area/ship/bridge)
"Wn" = (
/turf/closed/wall/mineral/plastitanium/nodiagonal,
/area/ship/bridge)
"Xe" = (
/obj/structure/chair/comfy/shuttle{
	dir = 4
	},
/turf/open/floor/mineral/plastitanium,
/area/ship/bridge)
"Yl" = (
/obj/machinery/power/terminal{
	dir = 8
	},
/obj/structure/cable{
	icon_state = "0-4"
	},
/obj/machinery/door/firedoor/border_only{
	dir = 8
	},
/obj/machinery/atmospherics/pipe/simple/purple,
/obj/effect/turf_decal/industrial/warning{
	dir = 8
	},
/turf/open/floor/plating,
/area/ship/engineering)
"YY" = (
/obj/structure/cable{
	icon_state = "2-8"
	},
/obj/structure/cable{
	icon_state = "0-8"
	},
/obj/machinery/power/terminal{
	dir = 1
	},
/obj/item/storage/secure/safe{
	pixel_x = 33;
	dir = 4
	},
/turf/open/floor/plasteel/dark,
/area/ship/bridge)
"Zc" = (
/obj/structure/cable,
/obj/machinery/power/port_gen/pacman{
	anchored = 1
	},
/obj/effect/turf_decal/trimline/opaque/white/filled/warning{
	dir = 9
	},
/turf/open/floor/plasteel/dark,
/area/ship/bridge)

(1,1,1) = {"
dJ
sx
sx
sx
sx
sx
sx
sx
sx
sx
sx
sx
dJ
"}
(2,1,1) = {"
dJ
TB
TB
TB
tx
sx
sx
sx
dJ
TB
TB
TB
dJ
"}
(3,1,1) = {"
dJ
Ep
Ep
Ep
Ng
TB
TB
TB
dJ
Ep
Ep
Ep
dJ
"}
(4,1,1) = {"
dJ
em
Yl
Yl
EK
Ep
Ep
Ep
dJ
ve
ve
ve
dJ
"}
(5,1,1) = {"
ju
Rr
dx
oa
if
Cy
St
Ho
dJ
cH
qJ
kK
dJ
"}
(6,1,1) = {"
dJ
ej
Pe
ie
Mj
HV
Fo
yJ
ix
hc
kS
ic
dJ
"}
(7,1,1) = {"
dJ
dJ
dJ
dJ
dJ
dJ
pQ
Wn
Wn
Wn
Wn
Wn
Wn
"}
(8,1,1) = {"
VA
Iu
wq
sn
yn
So
ip
Uu
PB
qu
KV
Hu
Md
"}
(9,1,1) = {"
Kt
kO
up
sn
Cu
ao
cu
zI
Zc
Wn
lt
Xe
Md
"}
(10,1,1) = {"
Wn
Wn
Iw
QR
Wn
Qn
Rt
LT
vC
Wn
ri
Vd
Md
"}
(11,1,1) = {"
sx
Wn
Wn
Wn
Wn
SR
Uc
YY
vD
Wn
Vd
Md
sx
"}
(12,1,1) = {"
sx
sx
sx
sx
Wn
Wn
Wn
Wn
Wn
Wn
sx
sx
sx
"}
